"我",我,,0,6,0.339525,0.370179,8447.363315,8,48,56,7,16,23,0,48,0.000881,0.035228,0.068976
"和",和,,5,6,0.367502,0.41722,105134.631976,97,97,194,73,71,144,0,48,0.011221,0.18073,0.196005
"的",的,,0,6,0.418858,0.485202,284979.577351,225,218,443,140,140,280,0,48,0.020132,0.338426,0.371598
"同",同,,0,6,0.351735,0.389746,16765.868256,44,53,97,18,36,54,0,48,0.002069,0.075553,0.132847
"事",事,,6,6,0.301514,0.326726,14198.163018,33,35,68,23,17,40,0,48,0.003109,0.052627,0.042804
"已",已,,5,7,0.302989,0.326391,9647.330945,20,26,46,18,10,28,0,48,0.002322,0.066547,0.033899
"经",经,,5,6,0.318117,0.34843,17442.353831,52,53,105,25,20,45,0,48,0.003159,0.092252,0.048956
"多",多,,2,6,0.348002,0.383259,29846.623484,36,39,75,27,26,53,0,48,0.004026,0.087034,0.08196
"次",次,,2,7,0.292191,0.318089,2468.538975,15,15,30,5,13,18,0,48,0.000779,0.011121,0.035454
"介",介,,2,8,0.223268,0.232274,1171.997337,5,5,10,5,1,6,0,48,0.001033,0.00798,0
"绍",绍,,2,7,0.287223,0.306654,1191.997337,5,5,10,1,3,4,0,48,0.00102,0,0.020204
"了",了,,2,6,0.343183,0.381061,31048.866279,48,46,94,30,34,64,0,48,0.005085,0.053099,0.111514
"有",有,,1,6,0.349969,0.391256,69017.879852,81,88,169,51,47,98,0,48,0.007638,0.154027,0.098442
"关",关,,1,6,0.340354,0.375381,28140.63582,65,67,132,27,30,57,0,48,0.004025,0.104483,0.092868
"情",情,,7,6,0.282421,0.30435,4917.028744,17,14,31,5,7,12,0,48,0.001423,0.026154,0.027833
"况",况,,7,8,0.222688,0.232757,1254.441836,11,3,14,2,3,5,0,48,0.000647,0.001427,0.001399
"今",今,,2,7,0.263096,0.281817,1483.054951,7,14,21,7,4,11,0,48,0.000935,0.029024,0.007853
"天",天,,2,7,0.282278,0.30031,4508.142095,8,7,15,5,6,11,0,48,0.001052,0.00548,0.022828
"愿",愿,,0,7,0.273553,0.290848,1416.198704,9,8,17,6,4,10,0,48,0.000477,0.0352,0.00532
"作",作,,5,6,0.347028,0.381898,15024.88783,53,41,94,14,26,40,0,48,0.002408,0.027339,0.101278
"一",一,,2,6,0.349639,0.3887,64173.785962,90,98,188,52,40,92,0,48,0.007634,0.187855,0.080094
"些",些,,2,7,0.298049,0.321787,4000.503792,21,21,42,4,13,17,0,48,0.000651,0.011592,0.036312
"补",补,,2,8,0.19244,0.198845,6.644723,1,1,2,1,1,2,0,48,0.000184,0.001857,0.000835
"充",充,,2,7,0.238044,0.249757,1171.105284,6,7,13,4,1,5,0,48,0.000457,0.016333,0.002414
"中",中,,5,6,0.334533,0.366951,55122.269854,142,236,378,72,25,97,0,48,0.009702,0.202331,0.070235
"方",方,,5,6,0.393159,0.44438,69965.069262,149,146,295,28,78,106,0,48,0.005665,0.060871,0.25446
"直",直,,2,6,0.28961,0.311405,497.169918,8,8,16,2,7,9,0,48,0.000457,0.005079,0.023167
"积",积,,8,8,0.222333,0.233623,1932.233839,15,18,33,12,2,14,0,48,0.001449,0.071305,0.000042
"极",极,,8,7,0.279799,0.303957,2509.405053,20,20,40,4,15,19,0,48,0.001312,0.000813,0.026546
"支",支,,3,7,0.255032,0.268949,4686.276438,19,20,39,17,3,20,0,48,0.001669,0.049278,0.000668
"持",持,,3,6,0.337368,0.369746,8733.30343,40,35,75,6,24,30,0,48,0.001716,0.008278,0.093221
"新",新,,4,7,0.319301,0.346526,18913.964093,26,31,57,21,13,34,0,48,0.003194,0.079162,0.053452
"冠",冠,,4,9,0.176006,0.181572,2578.236395,5,5,10,1,2,3,0,48,0.00035,0.002734,0.000256
"肺",肺,,7,9,0.171144,0.175377,1094,4,4,8,1,1,2,0,48,0.00029,0.000013,0
"炎",炎,,7,8,0.206252,0.212999,1114,4,4,8,1,1,2,0,48,0.000388,0,0.00184
"疫",疫,,7,7,0.259483,0.272806,5967.83531,22,22,44,14,3,17,0,48,0.002277,0.035976,0.002139
"苗",苗,,7,7,0.296858,0.319201,1695.711734,13,10,23,1,9,10,0,48,0.000787,0.000109,0.029697
"实",实,,2,7,0.320679,0.3524,34845.848846,66,63,129,38,26,64,0,48,0.005326,0.132089,0.043959
"施",施,,2,7,0.307841,0.334493,5329.659741,29,26,55,5,13,18,0,48,0.001416,0.018322,0.043543
"计",计,,2,7,0.280151,0.29788,5524.805931,18,16,34,8,5,13,0,48,0.001141,0.012144,0.01416
"划",划,,2,7,0.308608,0.332968,3910.397855,13,7,20,2,7,9,0,48,0.000362,0.005536,0.035045
"国",国,,5,6,0.409024,0.467339,141344.412112,321,319,640,64,108,172,0,48,0.009613,0.181471,0.319783
"全",全,,7,6,0.32394,0.354499,16255.701392,42,42,84,23,17,40,0,48,0.003108,0.101962,0.047672
"球",球,,7,6,0.310671,0.335516,1593.250044,13,13,26,1,10,11,0,48,0.000297,0.002438,0.034126
"免",免,,7,8,0.22853,0.23936,1201.683741,3,3,6,3,3,6,0,48,0.000745,0.001554,0.005717
"联",联,,1,6,0.318208,0.342915,3885.714673,10,10,20,7,6,13,0,48,0.00164,0.015545,0.037391
"盟",盟,,5,6,0.312675,0.337534,4282.659529,13,13,26,4,11,15,0,48,0.000866,0.021687,0.037773
"签",签,,0,8,0.201591,0.20863,1098.864314,4,4,8,4,1,5,0,48,0.000523,0.012232,0
"署",署,,0,7,0.252262,0.265979,1118.864314,4,3,7,1,3,4,0,48,0.000586,0,0.011089
"协",协,,7,7,0.272217,0.289607,2253.371305,14,15,29,12,5,17,0,48,0.001455,0.059262,0.004934
"议",议,,7,7,0.317122,0.344941,6834.735604,29,20,49,7,14,21,0,48,0.00191,0.011074,0.053265
"正",正,,0,7,0.326596,0.357632,17913.839626,44,45,89,25,23,48,0,48,0.003967,0.09968,0.054925
"式",式,,0,7,0.298847,0.321258,5099.49869,7,6,13,4,5,9,0,48,0.000764,0.01612,0.021448
"加",加,,5,7,0.31154,0.336421,8528.508876,21,26,47,17,13,30,0,48,0.002392,0.069379,0.024051
"入",入,,5,6,0.314085,0.339507,4483.677079,13,11,24,9,9,18,0,48,0.001745,0.007543,0.033723
"当",当,,5,7,0.27362,0.29391,3888.517747,12,17,29,7,9,16,0,48,0.00098,0.019815,0.016151
"前",前,,5,7,0.287816,0.311354,6341.445125,19,17,36,10,15,25,0,48,0.001569,0.030685,0.037402
"四",四,,2,7,0.243609,0.255535,565.516923,4,4,8,4,3,7,0,48,0.000585,0.024154,0.002253
"种",种,,2,7,0.254276,0.269532,1931.278513,5,6,11,5,6,11,0,48,0.000764,0.008761,0.005622
"病",病,,7,8,0.212908,0.221048,2390.090833,4,4,8,4,2,6,0,48,0.000828,0.005001,0.001845
"毒",毒,,7,7,0.245163,0.259031,814.613334,3,3,6,1,3,4,0,48,0.000493,0.000094,0.006814
"进",进,,8,7,0.3246,0.354822,10305.891797,38,38,76,20,16,36,0,48,0.002473,0.052186,0.064725
"三",三,,7,7,0.309981,0.334179,2695.857459,13,13,26,4,8,12,0,48,0.000824,0.004824,0.020268
"期",期,,0,7,0.304728,0.328896,1828.737475,10,9,19,7,7,14,0,48,0.000782,0.024891,0.033575
"临",临,,7,7,0.296543,0.317536,1123.062271,4,4,8,2,3,5,0,48,0.000294,0.004554,0.019201
"床",床,,2,9,0.189368,0.195699,8.564769,1,1,2,1,1,2,0,48,0.000225,0.000982,0.000083
"试",试,,2,8,0.233312,0.245145,1236.997218,4,5,9,3,3,6,0,48,0.00071,0.001621,0.002962
"验",验,,2,7,0.284439,0.302782,2918.691744,13,11,24,3,4,7,0,48,0.000651,0.004904,0.009588
"并",并,,5,6,0.299651,0.324036,4332.713782,7,13,20,7,13,20,0,48,0.001017,0.039914,0.026224
"且",且,,1,8,0.213724,0.221978,19.44916,1,1,2,1,1,2,0,48,0.000208,0.001341,0.000382
"具",具,,1,7,0.271554,0.288813,1640.608434,5,6,11,5,4,9,0,48,0.000979,0.007464,0.010581
"备",备,,0,8,0.196268,0.20246,372.651109,2,1,3,2,1,3,0,48,0.000439,0.003503,0.000012
"足",足,,0,7,0.243982,0.255539,1174.161911,2,2,4,2,2,4,0,48,0.000607,0.000226,0.002535
"够",够,,3,6,0.305731,0.328625,1426.533085,5,5,10,2,5,7,0,48,0.000539,0.002571,0.03288
"生",生,,6,6,0.321048,0.350538,22145.180388,35,34,69,23,18,41,0,48,0.004015,0.07874,0.056961
"产",产,,6,6,0.29474,0.315755,4331.524143,8,9,17,7,7,14,0,48,0.001237,0.02067,0.017584
"自",自,,0,6,0.303236,0.328296,14442.915461,25,26,51,22,13,35,0,48,0.002812,0.098263,0.022029
"给",给,,7,7,0.275037,0.291482,1488.243514,4,4,8,4,4,8,0,48,0.000718,0.003412,0.015029
"能",能,,3,7,0.326501,0.355345,8309.617417,25,24,49,15,14,29,0,48,0.002294,0.049898,0.047732
"力",力,,8,7,0.31921,0.348035,12913.112506,33,21,54,17,17,34,0,48,0.003057,0.045871,0.056115
"但",但,,5,6,0.292882,0.313827,94.279321,1,4,5,1,4,5,0,48,0.000243,0.003521,0.018985
"还",还,,5,6,0.311192,0.339925,7324.360617,13,16,29,12,14,26,0,48,0.001761,0.047595,0.046902
"是",是,,0,6,0.375547,0.423662,69043.882608,88,90,178,46,69,115,0,48,0.005772,0.124514,0.206343
"决",决,,7,7,0.280927,0.30066,4104.52802,26,26,52,10,9,19,0,48,0.001261,0.054323,0.013768
"定",定,,7,6,0.334032,0.364469,7740.865608,32,19,51,10,16,26,0,48,0.001704,0.013743,0.064297
"此",此,,5,6,0.309121,0.337922,8748.228571,26,26,52,15,20,35,0,48,0.001855,0.057502,0.046702
"举",举,,7,7,0.285605,0.305138,2603.31275,11,10,21,10,6,16,0,48,0.0011,0.020184,0.009111
"目",目,,0,7,0.30615,0.330038,4977.10509,17,11,28,9,7,16,0,48,0.001677,0.036319,0.030161
"以",以,,2,6,0.317754,0.346846,15130.732946,32,34,66,26,20,46,0,48,0.003515,0.063516,0.046696
"际",际,,5,7,0.301596,0.328149,2361.511986,29,29,58,2,17,19,0,48,0.000391,0.018606,0.030576
"行",行,,7,6,0.343288,0.379895,21316.783294,45,40,85,19,32,51,0,48,0.003488,0.024185,0.094479
"动",动,,8,6,0.344561,0.381166,17760.146093,43,39,82,14,32,46,0,48,0.00295,0.050982,0.096711
"促",促,,8,7,0.265539,0.280333,1391.845756,11,14,25,8,3,11,0,48,0.001098,0.030399,0.010106
"公",公,,0,7,0.292882,0.318313,21380.611265,45,49,94,30,15,45,0,48,0.004925,0.11555,0.025635
"平",平,,5,7,0.282923,0.304343,8161.987311,21,20,41,8,10,18,0,48,0.001508,0.022908,0.027777
"分",分,,2,6,0.31215,0.340613,14229.850546,30,27,57,14,16,30,0,48,0.002015,0.047194,0.027486
"配",配,,2,0,0,0,0,1,0,1,1,0,1,0,27,0.000248,0.001406,0
"确",确,,0,7,0.308522,0.33397,1882.800425,11,13,24,5,10,15,0,48,0.000741,0.01783,0.042013
"保",保,,3,7,0.281424,0.30069,3232.09221,16,17,33,14,6,20,0,48,0.001839,0.028573,0.012469
"为",为,,5,6,0.355209,0.398206,40149.076709,51,60,111,33,48,81,0,48,0.004809,0.104011,0.14449
"发",发,,0,7,0.303071,0.330068,34157.321457,72,72,144,52,17,69,0,48,0.007228,0.173076,0.027675
"展",展,,0,6,0.348438,0.383244,10342.996375,47,43,90,4,28,32,0,48,0.000868,0.003924,0.094061
"家",家,,5,6,0.350629,0.390224,10482.323236,64,60,124,5,39,44,0,48,0.000869,0.022924,0.126488
"提",提,,5,7,0.309378,0.334403,4633.235609,28,29,57,19,8,27,0,48,0.002016,0.091334,0.027592
"供",供,,5,6,0.29773,0.321794,999.086543,19,18,37,4,13,17,0,48,0.000643,0.022442,0.044925
"时",时,,0,6,0.318026,0.344993,6736.550845,22,19,41,10,12,22,0,48,0.001315,0.028976,0.034639
"带",带,,2,7,0.275717,0.293485,542.921798,9,9,18,6,3,9,0,48,0.000956,0.013265,0.012741
"更",更,,2,6,0.305479,0.32988,5240.862879,15,19,34,15,9,24,0,48,0.002173,0.029703,0.032401
"最",最,,8,6,0.304229,0.329581,4974.310487,10,15,25,8,11,19,0,48,0.000996,0.043316,0.03073
"大",大,,8,6,0.346704,0.381928,26133.892931,42,45,87,25,30,55,0,48,0.003471,0.078272,0.081336
"济",济,,5,6,0.324694,0.355531,1422.31535,36,36,72,2,19,21,0,48,0.000513,0.002775,0.067657
"体",体,,2,6,0.275377,0.295381,8472.437683,14,12,26,11,11,22,0,48,0.001782,0.016014,0.007065
"相",相,,1,7,0.300054,0.323096,5784.993449,19,22,41,14,9,23,0,48,0.002008,0.057904,0.025069
"信",信,,1,6,0.304312,0.332167,13545.178791,22,22,44,14,17,31,0,48,0.002206,0.045154,0.041615
"将",将,,5,6,0.3387,0.372616,9502.311642,25,33,58,15,24,39,0,48,0.001743,0.057813,0.095505
"助",助,,8,7,0.265413,0.284241,3212.092765,12,9,21,5,7,12,0,48,0.001221,0.007042,0.018314
"于",于,,8,7,0.29513,0.319769,7559.852697,21,21,42,12,17,29,0,48,0.001792,0.02623,0.040037
"增",增,,5,7,0.262415,0.279212,2358.542924,19,20,39,9,6,15,0,48,0.001151,0.026397,0.007503
"强",强,,0,7,0.27599,0.297177,11150.82398,17,20,37,13,10,23,0,48,0.001789,0.039068,0.0149
"企",企,,5,7,0.256558,0.270587,1469.799265,23,25,48,15,2,17,0,48,0.001932,0.074979,0.001665
"业",业,,5,6,0.339009,0.371809,9661.89276,35,27,62,9,22,31,0,48,0.002372,0.013214,0.080506
"谈",谈,,0,7,0.226396,0.236848,1308.289248,4,3,7,4,2,6,0,48,0.000663,0.010169,0.004376
"判",判,,0,8,0.251296,0.264528,481.639493,4,2,6,3,2,5,0,48,0.000682,0.004366,0.002812
"激",激,,2,8,0.215819,0.224458,0,0,1,1,0,1,1,0,49,0.000141,0,0
"励",励,,2,7,0.274969,0.293111,2217.677745,3,3,6,2,3,5,0,48,0.000355,0,0.014599
"高",高,,7,7,0.312939,0.339171,8936.250987,19,19,38,16,12,28,0,48,0.002021,0.067481,0.030473
"量",量,,8,7,0.304146,0.32675,1140.291577,8,4,12,5,4,9,0,48,0.000904,0.009227,0.032495
"在",在,,5,6,0.3758,0.421928,72826.7103,76,88,164,49,60,109,0,48,0.006998,0.127781,0.188468
"可",可,,3,7,0.291199,0.31246,6302.784881,22,24,46,18,10,28,0,48,0.002307,0.076266,0.019437
"及",及,,2,6,0.313555,0.339731,4900.368788,13,13,26,8,12,20,0,48,0.001351,0.016135,0.037695
"性",性,,0,7,0.318571,0.346346,11944.075263,21,17,38,15,12,27,0,48,0.00286,0.031628,0.035159
"担",担,,1,7,0.298928,0.320331,1687.80017,5,5,10,5,4,9,0,48,0.001023,0.016082,0.020871
"负",负,,0,7,0.258102,0.273773,2153.153447,9,9,18,6,4,10,0,48,0.000975,0.027565,0.004372
"这",这,,2,6,0.320771,0.351211,9337.604718,15,44,59,12,22,34,0,48,0.001423,0.064787,0.047493
"秉",秉,,3,7,0.252434,0.264899,126.502075,4,6,10,4,1,5,0,48,0.000451,0.024399,0.000423
"人",人,,6,6,0.358175,0.394589,47550.609236,70,67,137,40,32,72,0,48,0.005789,0.151256,0.101755
"类",类,,6,7,0.263158,0.281021,2893.717755,6,6,12,3,6,9,0,48,0.000475,0.00795,0.00742
"卫",卫,,0,7,0.248828,0.262556,1156.207442,2,2,4,2,2,4,0,48,0.000407,0.000381,0.009054
"健",健,,6,8,0.19893,0.206059,719.846716,3,3,6,3,1,4,0,48,0.000459,0.008062,0.000003
"康",康,,6,7,0.248109,0.26218,2218.832434,4,4,8,2,4,6,0,48,0.000697,0.000057,0.009388
"共",共,,0,6,0.286118,0.307474,11009.760665,29,32,61,21,10,31,0,48,0.0036,0.081188,0.012947
"理",理,,7,6,0.331254,0.36009,9598.393369,30,25,55,13,15,28,0,48,0.002758,0.030923,0.052812
"念",念,,3,0,0,0,0,2,0,2,2,0,2,0,21,0.000441,0.003365,0
"履",履,,7,7,0.255734,0.269445,151.952323,3,5,8,3,1,4,0,48,0.000506,0.003767,0.001237
"身",身,,2,6,0.299812,0.324126,2464.591486,12,12,24,6,12,18,0,48,0.000885,0.009975,0.031244
"承",承,,1,8,0.24441,0.256555,2462.900233,8,8,16,8,3,11,0,48,0.001026,0.037923,0.00105
"诺",诺,,1,7,0.274023,0.292714,1585.222341,5,4,9,2,4,6,0,48,0.000616,0.000248,0.011077
"推",推,,8,7,0.287519,0.307395,3127.631484,12,19,31,11,5,16,0,48,0.001349,0.032942,0.010374
"成",成,,2,7,0.331451,0.362161,14340.817625,21,21,42,12,17,29,0,48,0.001932,0.05415,0.051821
"品",品,,6,6,0.305563,0.329626,7211.737496,9,9,18,6,8,14,0,48,0.001145,0.006652,0.027073
"重",重,,8,7,0.297333,0.323536,13141.969293,32,31,63,18,18,36,0,48,0.003429,0.058917,0.030583
"要",要,,8,6,0.328909,0.359118,7986.146234,27,26,53,12,18,30,0,48,0.001774,0.022223,0.062479
"措",措,,2,8,0.23558,0.246719,202.374873,9,7,16,5,1,6,0,48,0.000829,0.006759,0.000937
"与",与,,5,6,0.323564,0.352586,7722.310974,20,23,43,12,16,28,0,48,0.001557,0.053967,0.068916
"政",政,,3,6,0.303319,0.326502,11111.052528,51,44,95,25,6,31,0,48,0.003327,0.093563,0.021233
"府",府,,3,6,0.336756,0.366771,703.05439,18,18,36,1,16,17,0,48,0.000613,0.001086,0.072461
"研",研,,7,8,0.238299,0.250706,489.878417,3,3,6,2,2,4,0,48,0.00051,0.00161,0.011267
"参",参,,5,7,0.24484,0.25707,2403.842016,5,5,10,4,2,6,0,48,0.000612,0.007568,0.002769
"起",起,,0,7,0.301841,0.323177,4989.364363,9,9,18,7,7,14,0,48,0.001248,0.014269,0.016608
"合",合,,5,7,0.305145,0.327886,8977.397183,47,48,95,33,7,40,0,48,0.004641,0.118742,0.026454
"向",向,,5,7,0.326596,0.35947,12255.237065,28,27,55,22,21,43,0,48,0.002736,0.075839,0.074319
"们",们,,0,6,0.34192,0.375964,3041.080875,38,38,76,2,27,29,0,48,0.000454,0.004986,0.084112
"也",也,,0,6,0.322347,0.354141,9297.027451,19,30,49,16,21,37,0,48,0.00207,0.055684,0.064493
"据",据,,1,6,0.328327,0.357115,3432.765253,13,15,28,4,13,17,0,48,0.000768,0.00147,0.057132
"所",所,,1,7,0.311714,0.337901,13901.362333,34,38,72,29,13,42,0,48,0.003584,0.119274,0.038113
"知",知,,5,0,0,0,0,3,0,3,2,0,2,0,22,0.000782,0.002039,0
"不",不,,0,6,0.335338,0.374499,51662.284438,52,68,120,44,44,88,0,48,0.005265,0.123207,0.068829
"少",少,,0,6,0.307078,0.330658,4321.400878,9,10,19,7,7,14,0,48,0.000906,0.020782,0.032238
"表",表,,0,7,0.258281,0.274807,2949.61211,22,23,45,15,6,21,0,48,0.001899,0.059746,0.007038
"达",达,,0,7,0.303815,0.325165,2363.476384,6,6,12,3,5,8,0,48,0.001019,0.00178,0.02019
"意",意,,0,7,0.326214,0.357273,22728.416667,36,36,72,20,20,40,0,48,0.003245,0.056435,0.053702
"双",双,,5,7,0.291351,0.311153,1409.004277,7,11,18,6,5,11,0,48,0.000741,0.022724,0.008932
"技",技,,7,7,0.244947,0.259919,6055.420268,12,12,24,9,5,14,0,48,0.001473,0.032992,0.014392
"术",术,,7,7,0.283571,0.30527,1868.392669,8,8,16,1,8,9,0,48,0.000392,0.000736,0.028359
"专",专,,7,7,0.259846,0.274333,70.077773,1,1,2,1,1,2,0,48,0.000183,0.001451,0.001173
"就",就,,5,6,0.320034,0.347922,8297.392948,16,20,36,15,15,30,0,48,0.001828,0.045547,0.045328
"认",认,,1,7,0.307671,0.331034,2714.702799,7,5,12,5,5,10,0,48,0.001265,0.004198,0.033127
"证",证,,0,7,0.267964,0.285208,524.157125,5,5,10,5,4,9,0,48,0.000758,0.009648,0.004881
"监",监,,7,7,0.249273,0.261913,1232.376974,3,3,6,3,3,6,0,48,0.000564,0.002501,0.000952
"管",管,,7,7,0.26322,0.278151,231.934184,3,2,5,3,2,5,0,48,0.000499,0.002507,0.003819
"等",等,,6,6,0.324128,0.35423,19871.932797,27,27,54,22,22,44,0,48,0.003205,0.049182,0.071938
"面",面,,7,6,0.324694,0.356099,9971.190822,27,27,54,9,20,29,0,48,0.001368,0.025479,0.055456
"标",标,,0,7,0.268093,0.285033,3038.614997,9,8,17,8,4,12,0,48,0.001034,0.026718,0.008558
"准",准,,0,7,0.301026,0.324187,1391.118924,11,9,20,6,6,12,0,48,0.000827,0.012411,0.020484
"密",密,,2,7,0.277501,0.29643,1607.341561,7,6,13,4,5,9,0,48,0.000809,0.006326,0.010753
"切",切,,1,7,0.292882,0.315061,2997.053286,13,12,25,7,9,16,0,48,0.000945,0.031939,0.027336
"沟",沟,,8,8,0.215002,0.22371,23.593543,2,2,4,2,1,3,0,48,0.000291,0.006167,0.001597
"通",通,,8,7,0.27362,0.292699,4364.683485,16,14,30,12,9,21,0,48,0.001603,0.031222,0.014268
"形",形,,0,8,0.25445,0.269602,1249.003841,12,12,24,7,4,11,0,48,0.001072,0.015355,0.004931
"优",优,,8,7,0.253409,0.26609,2337.179103,6,6,12,6,3,9,0,48,0.000813,0.009311,0.001134
"先",先,,6,7,0.307332,0.331668,4569.14702,14,14,28,8,10,18,0,48,0.001496,0.019937,0.021723
"包",包,,5,8,0.214836,0.223152,3435.543081,6,7,13,6,1,7,0,48,0.000577,0.034628,0
"括",括,,5,7,0.273351,0.291198,3455.543081,7,7,14,1,7,8,0,48,0.000631,0,0.016429
"捐",捐,,5,8,0.212219,0.220453,1096.764975,1,1,2,1,1,2,0,48,0.000218,0.00084,0
"赠",赠,,5,7,0.269064,0.285862,1116.764975,1,1,2,1,1,2,0,48,0.000326,0,0.009244
"无",无,,0,7,0.295443,0.32101,9318.11758,20,23,43,16,16,32,0,48,0.002309,0.059707,0.030423
"偿",偿,,5,7,0.238554,0.251339,224.296628,2,2,4,2,2,4,0,48,0.000283,0.008026,0.00277
"援",援,,8,8,0.234539,0.246721,2696.769511,5,4,9,5,3,8,0,48,0.000892,0.006557,0.002638
"驻",驻,,5,7,0.280503,0.298157,359.863284,10,10,20,4,4,8,0,48,0.000639,0.028208,0.0127
"瑞",瑞,,5,7,0.292038,0.311533,1096.907996,8,10,18,7,4,11,0,48,0.001097,0.028308,0.011523
"典",典,,5,7,0.278263,0.296731,759.82582,6,6,12,3,5,8,0,48,0.000582,0.026988,0.012501
"使",使,,5,7,0.259363,0.274593,1655.488376,11,12,23,7,5,12,0,48,0.000721,0.029081,0.004324
"馆",馆,,5,7,0.299409,0.320944,290.711619,6,6,12,1,4,5,0,48,0.000264,0.000221,0.024147
"做",做,,8,7,0.3125,0.337467,3562.995564,19,20,39,17,6,23,0,48,0.002026,0.07899,0.036264
"出",出,,8,6,0.331352,0.364499,16895.304387,41,41,82,23,24,47,0,48,0.00367,0.061722,0.075468
"回",回,,0,7,0.27275,0.289628,819.615946,5,5,10,5,4,9,0,48,0.000677,0.028173,0.009473
"应",应,,5,6,0.294118,0.318969,12929.94273,25,26,51,15,17,32,0,48,0.00174,0.057093,0.024511
"对",对,,5,7,0.318026,0.352334,29327.770537,59,67,126,35,33,68,0,48,0.004034,0.128035,0.07352
"示",示,,0,7,0.272018,0.292808,3996.339862,14,11,25,5,9,14,0,48,0.000732,0.029822,0.017337
"烈",烈,,0,7,0.268287,0.286316,2319.06599,5,5,10,2,4,6,0,48,0.000431,0.000848,0.009466
"满",满,,0,7,0.239888,0.252012,790.229905,3,3,6,2,3,5,0,48,0.000327,0.004699,0.004413
"华",华,,5,7,0.29404,0.317461,6083.709019,15,17,32,8,11,19,0,48,0.001441,0.020856,0.026497
"兴",兴,,5,7,0.245055,0.257397,1427.211823,3,2,5,3,2,5,0,48,0.000825,0.004321,0.002522
"年",年,,2,7,0.305982,0.333455,11833.766217,25,24,49,13,15,28,0,48,0.002517,0.014197,0.036801
"来",来,,2,7,0.320771,0.347991,6388.297186,25,16,41,9,12,21,0,48,0.001614,0.010258,0.053955
"严",严,,8,7,0.254857,0.269959,3085.257666,16,18,34,13,3,16,0,48,0.001737,0.054627,0.008423
"格",格,,8,7,0.243822,0.257354,2646.56193,7,7,14,3,5,8,0,48,0.000801,0.006077,0.003705
"遵",遵,,8,7,0.235133,0.245866,1088.731337,4,4,8,3,2,5,0,48,0.000437,0.005752,0.00011
"守",守,,8,6,0.304895,0.327369,2253.46779,6,6,12,3,5,8,0,48,0.000758,0.00214,0.032194
"地",地,,5,7,0.315954,0.34237,13926.02727,28,28,56,19,13,32,0,48,0.002922,0.052431,0.025319
"法",法,,8,6,0.323376,0.354918,13938.354343,38,35,73,14,19,33,0,48,0.003818,0.049465,0.050368
"律",律,,8,7,0.248773,0.262624,43.312161,6,3,9,2,2,4,0,48,0.000465,0.002902,0.003992
"息",息,,1,7,0.246572,0.259193,219.519124,7,2,9,2,2,4,0,48,0.000482,0.002143,0.004448
"讯",讯,,8,8,0.196927,0.204442,45.088851,1,1,2,1,1,2,0,48,0.000293,0.00073,0.001688
"基",基,,1,7,0.265034,0.280984,5902.18734,30,30,60,19,5,24,0,48,0.002899,0.062993,0.000676
"础",础,,1,7,0.267643,0.282925,187.974665,14,12,26,1,3,4,0,48,0.000634,0.000035,0.006177
"设",设,,2,6,0.338803,0.368326,9167.599199,29,25,54,10,16,26,0,48,0.001694,0.052915,0.057894
"建",建,,2,7,0.287965,0.308305,4360.769133,22,22,44,18,7,25,0,48,0.00247,0.044389,0.026032
"贡",贡,,8,8,0.203876,0.211397,1113.090079,7,7,14,7,1,8,0,48,0.000991,0.033768,0
"献",献,,8,7,0.25591,0.270666,1133.090079,7,2,9,1,2,3,0,48,0.000984,0,0.002981
"市",市,,4,8,0.246955,0.258827,1827.741076,8,8,16,7,1,8,0,48,0.001018,0.050804,0.000319
"场",场,,4,7,0.327748,0.357258,7725.27971,24,15,39,5,15,20,0,48,0.001923,0.006228,0.058477
"内",内,,3,6,0.325643,0.354694,4090.153696,26,26,52,7,13,20,0,48,0.000906,0.057669,0.053007
"欧",欧,,0,7,0.231809,0.241621,696.978619,2,3,5,2,1,3,0,48,0.000349,0.026398,0.00003
"洲",洲,,0,6,0.301514,0.323782,2669.445827,9,9,18,2,6,8,0,48,0.000616,0.000584,0.021479
"开",开,,0,7,0.277639,0.298618,6125.132122,21,22,43,13,10,23,0,48,0.001614,0.063237,0.01734
"放",放,,0,7,0.288039,0.30962,5103.22362,14,10,24,7,10,17,0,48,0.001062,0.028223,0.016193
"没",没,,1,7,0.265476,0.282238,1082.795518,8,8,16,8,3,11,0,48,0.00121,0.021978,0.009218
"任",任,,0,6,0.316222,0.339357,7902.786379,29,30,59,19,4,23,0,48,0.00254,0.097816,0.023389
"何",何,,0,6,0.32394,0.353229,1203.080703,22,22,44,2,17,19,0,48,0.000808,0.001532,0.048157
"下",下,,5,7,0.268934,0.285063,4116.991483,8,6,14,6,6,12,0,48,0.001241,0.006455,0.013636
"安",安,,7,7,0.271356,0.288426,4241.849595,22,25,47,14,6,20,0,48,0.0024,0.072385,0.011563
"借",借,,8,7,0.254566,0.26991,3083.576972,6,6,12,6,4,10,0,48,0.001244,0.010707,0.004001
"口",口,,8,6,0.31921,0.346383,3035.682193,17,14,31,6,13,19,0,48,0.000827,0.012912,0.05713
"端",端,,0,7,0.259786,0.275093,298.5637,6,6,12,2,5,7,0,48,0.000338,0.002914,0.001786
"抹",抹,,2,8,0.209508,0.217095,686.564045,4,4,8,4,1,5,0,48,0.000664,0.007957,0.000278
"黑",黑,,2,7,0.264783,0.280384,4493.268137,8,7,15,5,5,10,0,48,0.001276,0.005434,0.011111
"司",司,,0,7,0.273017,0.290502,509.267572,6,5,11,3,4,7,0,48,0.000565,0.019447,0.016371
"然",然,,0,7,0.278333,0.297792,3512.469168,6,6,12,3,6,9,0,48,0.000662,0.003305,0.010418
"打",打,,2,7,0.27096,0.288821,4229.252112,17,17,34,14,5,19,0,48,0.002092,0.04822,0.01402
"压",压,,2,7,0.277019,0.295601,1427.241723,11,9,20,3,7,10,0,48,0.000711,0.004754,0.02123
"电",电,,0,7,0.246518,0.261862,4149.199273,5,6,11,5,5,10,0,48,0.000819,0.047726,0.003624
"常",常,,0,7,0.314262,0.338932,2215.674633,11,11,22,4,8,12,0,48,0.000791,0.023024,0.035638
"治",治,,3,6,0.304895,0.329701,3289.364217,19,19,38,5,13,18,0,48,0.001121,0.015962,0.025918
"化",化,,0,7,0.325073,0.353566,8356.579383,18,15,33,11,13,24,0,48,0.00167,0.010022,0.057335
"悖",悖,,8,8,0.228016,0.238376,44.678906,1,1,2,1,1,2,0,48,0.000279,0.005035,0.001342
"奉",奉,,7,7,0.255734,0.269445,138.513452,2,2,4,2,1,3,0,48,0.000316,0.016997,0.001237
"由",由,,0,7,0.269976,0.288717,1019.046397,9,8,17,4,7,11,0,48,0.000609,0.016399,0.013565
"非",非,,0,7,0.272018,0.289216,4967.522736,13,14,27,11,8,19,0,48,0.001675,0.047096,0.011389
"歧",歧,,0,7,0.246572,0.257862,160.790665,6,6,12,5,1,6,0,48,0.00075,0.033089,0.000821
"视",视,,0,6,0.327075,0.35432,5312.467818,15,13,28,6,8,14,0,48,0.001505,0.016046,0.049895
"原",原,,5,7,0.262353,0.276067,1204.476002,15,15,30,9,3,12,0,48,0.001379,0.051414,0.004943
"则",则,,5,7,0.315239,0.339799,826.255537,16,9,25,3,5,8,0,48,0.000802,0.001627,0.034131
"违",违,,5,8,0.232147,0.243108,160.778106,7,7,14,5,2,7,0,48,0.000717,0.010291,0.004066
"反",反,,5,7,0.288188,0.30915,6149.282422,25,30,55,11,9,20,0,48,0.001258,0.049918,0.021527
"贸",贸,,6,7,0.253813,0.270483,3657.521109,13,13,26,9,7,16,0,48,0.002059,0.018209,0.009885
"投",投,,3,7,0.243769,0.255996,128.806267,3,3,6,3,2,5,0,48,0.00073,0.001402,0.000648
"资",资,,3,7,0.274631,0.293028,1497.320423,9,8,17,7,7,14,0,48,0.001163,0.005121,0.016316
"规",规,,8,7,0.262476,0.278249,2291.060427,13,12,25,9,6,15,0,48,0.00108,0.021396,0.006375
"客",客,,3,7,0.283715,0.304478,3287.804548,10,11,21,3,8,11,0,48,0.000891,0.006423,0.018989
"观",观,,3,7,0.273084,0.290406,4626.164032,8,8,16,5,6,11,0,48,0.001015,0.021083,0.012979
"态",态,,0,8,0.255969,0.273202,3505.105908,15,13,28,6,8,14,0,48,0.001321,0.025409,0.010601
"度",度,,7,7,0.301923,0.325539,3707.570806,19,13,32,6,10,16,0,48,0.00161,0.005929,0.026822
"纠",纠,,0,8,0.248219,0.261043,191.203672,2,3,5,2,2,4,0,48,0.000428,0.013742,0.005951
"错",错,,0,8,0.231809,0.241789,1077.04223,5,5,10,4,1,5,0,48,0.000662,0.028227,0.000009
"误",误,,0,7,0.301596,0.324247,1435.383174,6,5,11,2,5,7,0,48,0.000785,0.000176,0.026663
"避",避,,7,9,0.186155,0.192031,0,0,1,1,0,1,1,0,50,0.000141,0,0.000079
"营",营,,5,7,0.300377,0.322513,772.934593,6,7,13,5,5,10,0,48,0.000759,0.038856,0.024144
"消",消,,7,8,0.229471,0.243583,2067.011095,7,8,15,7,4,11,0,48,0.001086,0.01787,0.000272
"影",影,,7,2,0.666667,0.75,3360.063294,6,6,12,4,2,6,0,35,0.000535,0.023387,0
"响",响,,7,1,1,1,73.063294,5,1,6,1,1,2,0,34,0.000369,0,0.000169
"社",社,,7,7,0.268804,0.283389,1822.030958,17,17,34,7,2,9,0,48,0.000847,0.016552,0.002177
"会",会,,7,7,0.341187,0.376795,12753.845486,43,42,85,14,29,43,0,48,0.001996,0.037251,0.088372
"第",第,,7,7,0.266683,0.28309,3607.234259,12,14,26,11,4,15,0,48,0.001366,0.042872,0.010097
"美",美,,5,6,0.323564,0.350508,11201.332149,44,85,129,21,12,33,0,48,0.003628,0.076005,0.051478
"其",其,,5,7,0.285385,0.305144,2424.658854,9,12,21,9,8,17,0,48,0.00119,0.046992,0.029784
"他",他,,0,6,0.30895,0.332152,7015.548409,13,21,34,9,5,14,0,48,0.001563,0.007407,0.028501
"物",物,,6,7,0.291885,0.314726,5200.517328,19,18,37,6,12,18,0,48,0.00132,0.008614,0.019149
"军",军,,6,7,0.290895,0.311676,6912.117325,10,10,20,8,6,14,0,48,0.001338,0.040084,0.008612
"活",活,,8,7,0.305229,0.328589,3423.769015,15,15,30,10,5,15,0,48,0.001485,0.033324,0.026305
"调",调,,0,7,0.301189,0.322767,2476.137739,9,7,16,4,4,8,0,48,0.001268,0.001096,0.018546
"透",透,,0,8,0.238197,0.24998,1237.048476,4,4,8,3,2,5,0,48,0.000564,0.004419,0.002966
"明",明,,0,7,0.310326,0.336167,10278.172955,21,15,36,12,10,22,0,48,0.002141,0.038346,0.037208
"报",报,,7,7,0.246354,0.260179,1484.104959,16,15,31,10,4,14,0,48,0.00115,0.059251,0.001908
"道",道,,7,7,0.310412,0.337482,7425.772046,23,14,37,11,13,24,0,48,0.002131,0.011056,0.037782
"东",东,,5,7,0.278055,0.299725,7987.438485,17,17,34,12,8,20,0,48,0.001889,0.065422,0.013454
"、",、,,0,8,0.228296,0.239378,35.07556,2,2,4,2,2,4,0,48,0.000429,0.001787,0.005755
"南",南,,0,8,0.221494,0.231051,1161.98263,3,3,6,2,2,4,0,48,0.000561,0.00069,0.000113
"亚",亚,,0,7,0.27875,0.298038,4633.193385,9,9,18,4,7,11,0,48,0.00098,0.001073,0.019324
"苏",苏,,5,7,0.282636,0.300929,458.050017,4,4,8,2,4,6,0,48,0.000381,0.002424,0.014173
2,2,,2,9,0.19724,0.204657,1533.148644,2,2,4,2,2,4,0,48,0.000564,0.020339,0.000358
5,5,,2,8,0.245055,0.257682,1707.84246,2,2,4,2,2,4,0,48,0.000477,0.001946,0.00252
"个",个,,2,7,0.320034,0.349889,17198.332928,37,37,74,16,18,34,0,48,0.002939,0.049143,0.047149
"区",区,,5,6,0.336451,0.36559,4315.879134,20,19,39,6,13,19,0,48,0.001448,0.005317,0.06637
"许",许,,2,7,0.258281,0.271649,0,2,2,4,1,1,2,0,48,0.000279,0.005035,0.004452
"室",室,,2,7,0.284294,0.302723,139.184063,7,3,10,1,3,4,0,48,0.00028,0.00049,0.021323
"仅",仅,,0,7,0.278055,0.295646,163.003087,6,6,12,2,4,6,0,48,0.000319,0.019878,0.011542
"乌",乌,,4,9,0.183057,0.189103,1114.003185,1,1,2,1,1,2,0,48,0.00024,0.00964,0
"克",克,,4,8,0.223896,0.234749,2250.003185,2,2,4,2,2,4,0,48,0.000466,0,0.002025
"兰",兰,,4,7,0.261983,0.27653,1265.46806,3,3,6,2,3,5,0,48,0.000505,0.000524,0.006924
"立",立,,4,7,0.320956,0.348798,6233.618187,25,24,49,13,10,23,0,48,0.00147,0.054929,0.054319
1,1,,2,7,0.221714,0.231253,1203.860156,2,2,4,2,2,4,0,48,0.00033,0.01872,0.00059
6,6,,2,8,0.242655,0.254678,208.382159,1,1,2,1,1,2,0,48,0.000282,0.00003,0.002514
"曾",曾,,1,7,0.266746,0.284713,2429.884921,4,4,8,4,4,8,0,48,0.000724,0.00372,0.017223
"暴",暴,,2,8,0.253294,0.268735,2689.201912,5,6,11,4,4,8,0,48,0.000935,0.00475,0.01128
"过",过,,8,7,0.295992,0.318149,5535.171887,13,10,23,9,9,18,0,48,0.001739,0.016159,0.022219
"模",模,,8,7,0.25445,0.269259,161.111122,4,4,8,1,4,5,0,48,0.000294,0.000326,0.007655
"传",传,,8,8,0.224211,0.234342,1300.939505,4,4,8,3,3,6,0,48,0.000372,0.002812,0.000684
"染",染,,7,7,0.245649,0.258249,1530.193225,3,2,5,3,2,5,0,48,0.000752,0.000254,0.002771
"日",日,,5,7,0.27436,0.291012,2085.607534,9,11,20,9,5,14,0,48,0.001217,0.010646,0.009121
"外",外,,6,6,0.320771,0.347713,9669.193307,29,31,60,22,13,35,0,48,0.002553,0.083425,0.036906
"数",数,,0,7,0.295443,0.317198,4167.04555,9,9,18,5,6,11,0,48,0.000703,0.041108,0.012128
"百",百,,0,7,0.244089,0.255306,1129.570972,3,3,6,3,2,5,0,48,0.000465,0.004708,0.000732
"接",接,,6,7,0.291961,0.311563,1493.060533,8,7,15,7,4,11,0,48,0.000721,0.029612,0.010426
"触",触,,6,7,0.247228,0.260799,37.518764,4,3,7,1,3,4,0,48,0.000295,0.000533,0.004846
"致",致,,6,7,0.281424,0.300794,3794.915449,10,10,20,8,7,15,0,48,0.001263,0.010726,0.019193
"命",命,,6,8,0.198117,0.205633,1179.417182,2,2,4,1,2,3,0,48,0.000295,0.000982,0.000256
"微",微,,6,7,0.24329,0.255127,983.950995,1,1,2,1,1,2,0,48,0.000266,0.000013,0.004028
"故",故,,6,8,0.237689,0.248587,45.4754,2,1,3,1,1,2,0,48,0.000297,0.002189,0.000903
"导",导,,6,7,0.270303,0.285473,881.910063,10,10,20,5,3,8,0,48,0.001208,0.013543,0.010556
"者",者,,6,7,0.298607,0.32063,1739.339275,5,5,10,5,5,10,0,48,0.000877,0.007741,0.022572
"被",被,,6,7,0.249497,0.263521,761.359314,5,5,10,5,5,10,0,48,0.000872,0.009722,0.009297
"感",感,,7,7,0.245649,0.258894,2262.082487,4,3,7,4,3,7,0,48,0.000715,0.004983,0.004262
"播",播,,8,7,0.254566,0.267886,298.433366,1,1,2,1,1,2,0,48,0.000247,0.000035,0.000764
"到",到,,0,6,0.340979,0.375516,10366.689342,35,33,68,14,23,37,0,48,0.002436,0.014929,0.094724
"流",流,,6,7,0.292958,0.31379,1896.187105,11,10,21,3,7,10,0,48,0.00049,0.005065,0.01723
"什",什,,1,8,0.223536,0.232686,1288.045686,10,10,20,5,1,6,0,48,0.000875,0.023248,0
"么",么,,1,7,0.287668,0.308149,1308.045686,10,9,19,1,9,10,0,48,0.000885,0,0.023043
"世",世,,7,7,0.252491,0.265798,2331.9596,21,23,44,12,2,14,0,48,0.001703,0.045016,0.001199
"界",界,,7,6,0.332538,0.363318,5011.133543,27,27,54,4,19,23,0,48,0.001328,0.00524,0.061367
"如",如,,2,7,0.270434,0.288119,1725.889247,6,7,13,6,6,12,0,48,0.000896,0.016684,0.006569
"之",之,,5,7,0.295364,0.31826,5559.805116,14,13,27,13,10,23,0,48,0.002054,0.034582,0.029406
"主",主,,8,7,0.283932,0.304299,6548.47693,15,15,30,11,8,19,0,48,0.001607,0.036673,0.007435
"从",从,,6,6,0.277709,0.296442,4305.975983,12,12,24,10,5,15,0,48,0.001248,0.047961,0.013683
"攫",攫,,0,8,0.221935,0.230996,17.436387,1,1,2,1,1,2,0,48,0.00016,0.00647,0.0004
"取",取,,0,7,0.284948,0.304777,3510.82352,10,11,21,6,6,12,0,48,0.000971,0.00783,0.019768
"敏",敏,,7,8,0.197345,0.204223,9.273298,1,1,2,1,1,2,0,48,0.000251,0.001649,0.000255
"源",源,,3,7,0.269845,0.287297,422.392697,4,2,6,3,2,5,0,48,0.000603,0.003549,0.009316
"否",否,,0,8,0.216295,0.224925,76.3318,2,2,4,1,2,3,0,48,0.000212,0.010555,0.000675
"符",符,,5,8,0.233949,0.243843,166.480767,4,2,6,4,1,5,0,48,0.000549,0.009649,0.006074
"存",存,,5,7,0.273284,0.289137,990.494265,2,2,4,2,1,3,0,48,0.000333,0.003555,0.006536
"泄",泄,,6,9,0.15199,0.155847,957.336764,2,2,4,2,1,3,0,48,0.000405,0.010578,0.000123
"漏",漏,,6,8,0.179059,0.184982,4395,4,3,7,3,2,5,0,48,0.000846,0.00241,0
"隐",隐,,6,1,1,1,1096,1,1,2,1,1,2,0,8,0.000501,0,0
"患",患,,6,0,0,0,0,1,0,1,1,0,1,0,7,0.000567,0,0
"十",十,,2,7,0.300539,0.322191,3340.350339,10,10,20,9,5,14,0,48,0.001209,0.018054,0.016943
"几",几,,2,8,0.252377,0.267016,110.436263,2,2,4,2,2,4,0,48,0.000503,0.001333,0.00324
"独",独,,4,7,0.265476,0.282031,741.74942,9,9,18,6,3,9,0,48,0.000622,0.032953,0.004093
"禁",禁,,6,8,0.237588,0.250311,1294.520939,7,7,14,4,3,7,0,48,0.000621,0.011593,0.000281
"止",止,,4,7,0.282923,0.30231,2121.604615,10,9,19,2,7,9,0,48,0.000714,0.000014,0.014258
"武",武,,6,8,0.198293,0.206156,274.58927,7,7,14,5,1,6,0,48,0.000666,0.008226,0.000017
"器",器,,6,7,0.247119,0.262814,1362.066945,8,7,15,2,4,6,0,48,0.001143,0.000324,0.010489
"约",约,,0,7,0.245541,0.25867,287.758252,3,3,6,2,3,5,0,48,0.000678,0.001547,0.001361
"核",核,,4,7,0.280362,0.302594,2655.919927,11,11,22,7,7,14,0,48,0.001357,0.003953,0.024995
"查",查,,7,7,0.253409,0.269338,3003.880225,8,6,14,4,5,9,0,48,0.001342,0.001309,0.003412
"书",书,,7,8,0.184756,0.190552,25.274374,2,1,3,1,1,2,0,48,0.000232,0.003289,0.00052
"问",问,,4,8,0.239219,0.250219,2358.389254,28,28,56,14,1,15,0,48,0.001701,0.02974,0
"题",题,,4,7,0.314173,0.340442,2378.389254,28,17,45,1,11,12,0,48,0.001587,0,0.048836
"只",只,,1,7,0.27315,0.289276,232.600125,5,6,11,4,2,6,0,48,0.000731,0.009827,0.009015
"答",答,,0,7,0.227412,0.237822,0,3,1,4,2,1,3,0,48,0.000347,0.0135,0.00292
"真",真,,0,7,0.303401,0.325742,659.610696,4,6,10,4,4,8,0,48,0.000673,0.018368,0.026953
"才",才,,3,7,0.284004,0.301691,1267.217998,5,5,10,5,3,8,0,48,0.00063,0.010294,0.012325
"该",该,,5,7,0.286118,0.304704,178.896203,6,6,12,1,5,6,0,48,0.000228,0.001254,0.015235
"本",本,,1,6,0.31515,0.342915,4540.725323,18,18,36,8,13,21,0,48,0.001531,0.008598,0.036925
"着",着,,0,8,0.255617,0.271545,1396.379533,5,5,10,5,5,10,0,48,0.000794,0.008932,0.015064
"责",责,,0,7,0.310671,0.334657,3235.909061,14,12,26,7,5,12,0,48,0.001321,0.027164,0.036031
"义",义,,5,6,0.308181,0.33272,3170.522326,13,11,24,7,10,17,0,48,0.001097,0.010415,0.038084
"务",务,,5,7,0.311279,0.338843,9974.541078,25,23,48,10,14,24,0,48,0.002005,0.045957,0.035375
"境",境,,5,7,0.290365,0.313479,2121.01536,17,15,32,4,12,16,0,48,0.00077,0.018836,0.029963
"澄",澄,,2,9,0.191581,0.197869,19.484268,1,1,2,1,1,2,0,48,0.000199,0.002837,0.000332
"清",清,,2,8,0.23673,0.24841,4730.106241,8,7,15,5,3,8,0,48,0.000821,0.006491,0.000147
"停",停,,4,8,0.220705,0.229548,983.706925,5,8,13,4,1,5,0,48,0.000466,0.007134,0.000001
"阻",阻,,5,7,0.295992,0.316415,2207,2,2,4,2,2,4,0,48,0.000677,0.006487,0.017356
"挡",挡,,5,8,0.219229,0.229292,10.726205,1,1,2,1,1,2,0,48,0.000429,0.000888,0.000202
"防",防,,2,8,0.217859,0.228238,1132.726769,3,3,6,3,2,5,0,48,0.000439,0.020264,0.001187
"弹",弹,,0,7,0.235083,0.245313,159.824525,1,1,2,1,1,2,0,48,0.000328,0.000061,0.001063
"团",团,,5,8,0.222688,0.23421,2330.661717,4,4,8,3,4,7,0,48,0.000472,0.008431,0.002213
"涉",涉,,4,7,0.278124,0.297739,6197.588657,25,21,46,11,9,20,0,48,0.00141,0.029585,0.016479
"朝",朝,,0,8,0.238809,0.251929,175.246758,3,3,6,3,3,6,0,48,0.000354,0.007786,0.009515
"鲜",鲜,,0,8,0.237083,0.247795,212.038866,2,1,3,2,1,3,0,48,0.000343,0.004007,0.000861
"战",战,,3,7,0.310412,0.335405,8656.153625,15,14,29,10,7,17,0,48,0.001962,0.016836,0.028001
"争",争,,0,7,0.261308,0.276991,1212.261491,2,2,4,2,2,4,0,48,0.000574,0.001436,0.01032
"言",言,,0,7,0.27315,0.2901,5705.676163,11,9,20,8,5,13,0,48,0.001539,0.01054,0.011442
"论",论,,0,7,0.250337,0.263408,1716.018449,8,4,12,5,4,9,0,48,0.001102,0.003755,0.000912
"史",史,,1,7,0.27882,0.297066,1265.21015,5,4,9,2,3,5,0,48,0.000625,0.002395,0.009485
"鉴",鉴,,8,0,0,0,0,2,0,2,2,0,2,0,24,0.000491,0.007595,0
"未",未,,6,7,0.247064,0.260914,1864.955784,5,5,10,3,4,7,0,48,0.000587,0.023509,0.001837
"珍",珍,,5,8,0.212075,0.220335,0,0,1,1,0,1,1,0,52,0.000141,0,0
"爱",爱,,5,7,0.268916,0.285755,1116,1,1,2,1,1,2,0,51,0.000261,0,0.009244
"友",友,,8,7,0.25644,0.270246,231.37462,9,9,18,7,2,9,0,48,0.00093,0.037067,0.003461
"好",好,,8,6,0.327363,0.357803,7975.873355,23,18,41,15,17,32,0,48,0.002544,0.033665,0.067525
"追",追,,8,8,0.219402,0.228393,1376.073158,3,3,6,3,2,5,0,48,0.000513,0.026531,0.00019
"求",求,,8,7,0.279309,0.297021,4017.95202,10,9,19,5,8,13,0,48,0.001053,0.003703,0.017448
"注",注,,0,7,0.303071,0.325584,1043.25563,14,12,26,6,4,10,0,48,0.000649,0.018144,0.023597
"韩",韩,,5,7,0.304728,0.325569,61.269977,3,3,6,3,3,6,0,48,0.00061,0.015233,0.014292
"交",交,,6,6,0.306571,0.332272,6732.992943,26,27,53,12,12,24,0,48,0.002037,0.048966,0.032185
"部",部,,2,7,0.274225,0.295802,4795.495711,17,17,34,11,11,22,0,48,0.001679,0.02314,0.022336
"点",点,,7,8,0.256381,0.27342,5714.420984,7,6,13,7,6,13,0,48,0.001969,0.006456,0.015005
"近",近,,0,7,0.254276,0.268578,622.934029,6,7,13,6,5,11,0,48,0.000742,0.021189,0.003165
"两",两,,5,7,0.295756,0.317139,10590.468226,23,23,46,20,6,26,0,48,0.004051,0.04004,0.014429
"努",努,,8,8,0.242128,0.253789,34.808812,6,6,12,3,1,4,0,48,0.000364,0.017793,0.002346
"至",至,,2,7,0.270172,0.289154,4443.235062,10,10,20,4,9,13,0,48,0.001322,0.013657,0.008083
"你",你,,5,7,0.306403,0.328552,2141.511329,4,5,9,4,4,8,0,48,0.000687,0.002559,0.033428
"海",海,,5,7,0.266619,0.282874,1610.71882,6,7,13,6,4,10,0,48,0.000848,0.045305,0.009754
"门",门,,2,8,0.235182,0.248105,188.763139,5,4,9,2,4,6,0,48,0.000602,0.001244,0.007126
"制",制,,0,7,0.315596,0.34249,7884.804895,14,13,27,8,10,18,0,48,0.001716,0.011202,0.045061
"台",台,,5,7,0.288039,0.308215,5184.849786,12,17,29,10,7,17,0,48,0.001797,0.024799,0.00701
"谓",谓,,1,6,0.321882,0.349955,453.360238,19,19,38,1,11,12,0,48,0.000376,0.00195,0.054784
"策",策,,3,7,0.286485,0.307506,434.479297,7,5,12,2,5,7,0,48,0.000732,0.00179,0.019312
"互",互,,1,7,0.284004,0.303993,4088.77405,15,15,30,11,8,19,0,48,0.00178,0.036356,0.013484
"利",利,,5,7,0.327267,0.354837,8631.092854,21,19,40,15,12,27,0,48,0.002135,0.030044,0.048222
"变",变,,0,7,0.271158,0.287886,3394.101138,7,6,13,7,3,10,0,48,0.000788,0.042899,0.007109
"希",希,,0,8,0.198257,0.205689,382.531044,5,6,11,4,1,5,0,48,0.000417,0.010625,0.000014
"望",望,,0,7,0.247064,0.261847,1204.365483,7,6,13,2,5,7,0,48,0.000597,0.000273,0.006966
"似",似,,0,7,0.251353,0.265644,57.935781,1,1,2,1,1,2,0,48,0.000209,0.00038,0.006302
"评",评,,5,8,0.203504,0.211403,94.869698,2,2,4,2,2,4,0,48,0.000445,0.003658,0.000283
"继",继,,3,8,0.240561,0.251748,305.550321,9,10,19,3,1,4,0,48,0.00053,0.006704,0.000264
"续",续,,3,7,0.316492,0.343596,4307.847758,18,18,36,4,13,17,0,48,0.001154,0.005154,0.046262
"干",干,,4,8,0.237386,0.251857,5516.264501,15,15,30,14,5,19,0,48,0.001959,0.050928,0.003265
"扰",扰,,4,7,0.27129,0.289949,3263.680105,6,4,10,2,4,6,0,48,0.00097,0.000167,0.012226
"系",系,,1,6,0.322721,0.350807,2896.519013,18,15,33,2,11,13,0,48,0.000393,0.005112,0.040249
"气",气,,0,9,0.179376,0.185415,1166.006035,2,2,4,2,2,4,0,48,0.000335,0.003328,0.000091
"氛",氛,,0,0,0,0,0,1,0,1,1,0,1,0,40,0.000284,0.000005,0
"谢",谢,,5,8,0.2347,0.24447,0,1,2,3,1,2,3,0,53,0.000141,0,0.000131
"李",李,,4,9,0.183071,0.189113,0,0,1,1,0,1,1,0,54,0.000141,0,0
"总",总,,8,7,0.264218,0.279586,767.089374,6,7,13,5,5,10,0,48,0.000714,0.007824,0.005929
"领",领,,6,7,0.260758,0.275101,5254.533155,25,24,49,21,4,25,0,48,0.002544,0.060808,0.001896
"上",上,,1,6,0.333732,0.366398,20094.26795,31,28,59,20,24,44,0,48,0.003223,0.0498,0.06024
"宣",宣,,1,8,0.234737,0.245115,27.376822,2,2,4,1,1,2,0,48,0.000255,0.003081,0.000159
"布",布,,0,7,0.306403,0.330248,4544.426413,9,9,18,4,6,10,0,48,0.001155,0.003101,0.024806
"菁",菁,,1,10,0.151907,0.155406,1094.716667,2,3,5,2,1,3,0,48,0.000395,0.003584,0
"英",英,,1,9,0.178944,0.183979,1114.716667,3,3,6,1,1,2,0,48,0.000477,0,0.000978
"奖",奖,,1,8,0.217688,0.226192,3258.122313,5,5,10,3,1,4,0,48,0.000953,0.019127,0.00031
"学",学,,1,7,0.278055,0.296304,8102.053563,14,14,28,6,6,12,0,48,0.001749,0.006053,0.012425
"金",金,,1,6,0.308437,0.332078,3463.193379,13,12,25,4,10,14,0,48,0.001381,0.00224,0.026414
"王",王,,5,8,0.225247,0.233827,0,0,1,1,0,1,1,0,56,0.000141,0,0
"毅",毅,,5,7,0.290474,0.30873,1116,1,1,2,1,1,2,0,55,0.000261,0,0.009282
"委",委,,6,7,0.247723,0.259549,53.377678,2,2,4,2,1,3,0,48,0.000351,0.002846,0.000467
"员",员,,6,6,0.329006,0.35855,3581.145077,19,16,35,5,16,21,0,48,0.001107,0.009128,0.062022
"兼",兼,,6,7,0.243078,0.254149,2.739322,1,1,2,1,1,2,0,48,0.0002,0.003172,0.004267
"长",长,,0,7,0.317393,0.345136,2889.755487,23,16,39,8,12,20,0,48,0.001109,0.029557,0.043279
"各",各,,5,7,0.312412,0.336391,5882.789595,19,20,39,16,8,24,0,48,0.001666,0.091036,0.020427
"席",席,,1,9,0.1978,0.205184,1198.612401,3,2,5,3,2,5,0,48,0.000668,0.004252,0.001352
"启",启,,8,7,0.25644,0.270164,48.287702,2,2,4,2,1,3,0,48,0.000349,0.004312,0.002608
"仪",仪,,0,8,0.230229,0.240175,46.76316,1,1,2,1,1,2,0,48,0.00022,0.004947,0.000825
"首",首,,2,7,0.274158,0.290645,578.077686,3,6,9,3,4,7,0,48,0.000394,0.032274,0.005239
"话",话,,3,9,0.170934,0.175587,345.253543,1,1,2,1,1,2,0,48,0.000245,0.003761,0.000275
"伙",伙,,3,8,0.205986,0.213485,2211.028635,4,4,8,3,1,4,0,48,0.000509,0.00537,0
"伴",伴,,3,7,0.259182,0.274025,2231.028635,4,2,6,1,2,3,0,48,0.000574,0,0.009497
"项",项,,0,7,0.260758,0.274982,4283.274161,13,13,26,11,4,15,0,48,0.002389,0.033648,0.01065
"—",—,,5,8,0.229897,0.240746,1199.237181,3,3,6,2,2,4,0,48,0.000667,0.0164,0.004273
"创",创,,2,8,0.249106,0.261829,75.235306,1,2,3,1,2,3,0,48,0.000264,0.019008,0.004952
"型",型,,5,7,0.241133,0.254491,2244.034571,4,3,7,3,3,6,0,48,0.000547,0.007534,0.004564
"旗",旗,,0,8,0.21718,0.227541,3573.16314,3,3,6,2,3,5,0,48,0.000631,0.000235,0.000995
"舰",舰,,0,8,0.207057,0.21413,44.930219,1,1,2,1,1,2,0,48,0.00032,0.000051,0.001721
"夯",夯,,2,8,0.242972,0.255425,0,1,1,2,1,1,2,0,48,0.000226,0.007391,0.006756
"文",文,,6,7,0.247943,0.26233,2052.43464,8,8,16,4,5,9,0,48,0.001055,0.009178,0.005828
"柱",柱,,3,8,0.232777,0.24399,83.344288,1,1,2,1,1,2,0,48,0.000614,0.000034,0.008853
"挥",挥,,0,7,0.265666,0.282419,119.898677,3,3,6,1,3,4,0,48,0.000503,0.001416,0.008952
"用",用,,5,6,0.310931,0.336861,6046.36525,18,15,33,8,13,21,0,48,0.001058,0.024078,0.034768
"始",始,,0,8,0.25175,0.265745,1168.868804,4,7,11,4,2,6,0,48,0.000506,0.031088,0.003889
"终",终,,0,7,0.277363,0.295864,226.631527,6,6,12,1,5,6,0,48,0.000356,0.000199,0.009252
"把",把,,0,7,0.247778,0.262676,2345.138197,6,6,12,4,5,9,0,48,0.000434,0.030815,0.010583
"周",周,,5,7,0.243663,0.25518,330.754161,8,7,15,7,2,9,0,48,0.000956,0.025299,0.00175
"边",边,,5,6,0.321604,0.347967,3761.465462,16,16,32,9,9,18,0,48,0.001407,0.032168,0.036336
"稳",稳,,7,7,0.260697,0.277465,2669.319829,17,20,37,9,6,15,0,48,0.001178,0.019244,0.004615
"远",远,,0,7,0.295443,0.315398,262.905613,4,2,6,4,1,5,0,48,0.000649,0.004859,0.017311
"教",教,,1,7,0.247283,0.262364,2510.960587,5,6,11,2,4,6,0,48,0.000737,0.010052,0.007491
"育",育,,1,7,0.253179,0.266647,158.894286,2,2,4,1,2,3,0,48,0.000298,0.000383,0.008589
"域",域,,6,7,0.321141,0.348245,2505.318063,15,14,29,2,11,13,0,48,0.000777,0.003492,0.048597
"功",功,,0,6,0.284004,0.302646,79.34736,1,2,3,1,2,3,0,48,0.000201,0.000881,0.012838
"去",去,,5,8,0.244786,0.259626,545.541388,2,3,5,2,3,5,0,48,0.000375,0.019666,0.001957
"再",再,,2,7,0.253755,0.26915,1207.17341,6,6,12,5,3,8,0,48,0.00064,0.014416,0.003426
"造",造,,2,7,0.311627,0.337512,8890.049556,15,15,30,10,10,20,0,48,0.002194,0.01765,0.032289
"牌",牌,,6,8,0.207018,0.214108,7.635965,1,1,2,1,1,2,0,48,0.000263,0.001385,0.001721
"鼓",鼓,,2,8,0.216547,0.225928,2194.264244,2,3,5,2,2,4,0,48,0.000222,0.004732,0
"秀",秀,,8,9,0.190143,0.196442,1100.811111,1,1,2,1,1,2,0,48,0.000372,0.000058,0
"青",青,,8,8,0.234539,0.245964,1120.811111,1,1,2,1,1,2,0,48,0.000457,0,0.000726
"习",习,,1,8,0.226396,0.237738,2296.227186,4,4,8,2,3,5,0,48,0.000706,0.000637,0.001087
"深",深,,0,7,0.256617,0.272135,2444.670902,5,6,11,5,5,10,0,48,0.000783,0.010488,0.002055
"断",断,,0,7,0.27275,0.293156,2942.329879,9,8,17,4,8,12,0,48,0.00091,0.005076,0.023344
"智",智,,8,8,0.212139,0.220401,1102.551208,2,2,4,2,1,3,0,48,0.000698,0.005188,0
"慧",慧,,8,7,0.268999,0.285832,1122.551208,2,1,3,1,1,2,0,48,0.000734,0,0.009244
"阿",阿,,3,8,0.216127,0.224841,1900.972181,3,3,6,3,2,5,0,48,0.000432,0.023919,0.000053
"尔",尔,,3,7,0.253928,0.268524,1737.824354,4,4,8,3,4,7,0,48,0.000771,0.001038,0.006372
"维",维,,3,7,0.27868,0.299201,3780.682518,11,16,27,8,5,13,0,48,0.001059,0.023895,0.012994
"统",统,,8,7,0.272616,0.289524,913.272631,7,7,14,5,4,9,0,48,0.000544,0.013078,0.011416
"巴",巴,,5,7,0.29781,0.319276,3267.967932,13,14,27,6,7,13,0,48,0.001408,0.027951,0.018572
"走",走,,6,7,0.274766,0.292872,5106.013438,12,12,24,10,5,15,0,48,0.001567,0.022476,0.013488
"廊",廊,,6,7,0.30127,0.324098,406.137391,6,6,12,1,5,6,0,48,0.000408,0.00069,0.028737
"赞",赞,,0,7,0.25416,0.268181,2081.168031,11,10,21,11,4,15,0,48,0.001749,0.037175,0.006479
"赏",赏,,0,8,0.229613,0.239132,23.083319,3,1,4,1,1,2,0,48,0.000513,0.000331,0.00143
"说",说,,2,6,0.281922,0.302601,5546.575194,11,9,20,10,8,18,0,48,0.001303,0.044644,0.013085
"路",路,,0,6,0.321882,0.350643,6811.004438,14,14,28,5,12,17,0,48,0.001659,0.025434,0.044884
"繁",繁,,7,9,0.202103,0.20956,44.677187,4,4,8,3,1,4,0,48,0.000312,0.012156,0.000403
"荣",荣,,7,8,0.253121,0.267883,1287.690891,6,4,10,3,3,6,0,48,0.000652,0.007883,0.013289
"港",港,,4,7,0.29513,0.316647,2182.632511,8,9,17,3,7,10,0,48,0.000653,0.001172,0.015748
"得",得,,0,7,0.305396,0.330053,8181.698499,19,21,40,12,14,26,0,48,0.001768,0.022652,0.032637
"很",很,,2,7,0.262106,0.277373,2440.635864,5,6,11,5,3,8,0,48,0.000884,0.01486,0.00643
"看",看,,0,7,0.277432,0.295398,731.954239,4,4,8,4,4,8,0,48,0.000745,0.012487,0.011842
"果",果,,2,7,0.291579,0.311108,5653.783788,9,5,14,4,5,9,0,48,0.00099,0.00321,0.015255
"斯",斯,,1,7,0.269194,0.28543,1069.791428,6,7,13,4,5,9,0,48,0.001084,0.001246,0.003795
"坦",坦,,1,7,0.299973,0.320801,1253.415142,4,4,8,2,4,6,0,48,0.000436,0.002323,0.017988
"都",都,,5,6,0.311714,0.338894,4697.147865,13,14,27,10,11,21,0,48,0.001548,0.033988,0.039993
"商",商,,5,6,0.318026,0.344514,2893.557959,15,14,29,9,10,19,0,48,0.0014,0.039988,0.04391
"探",探,,6,9,0.177555,0.182606,0,0,1,1,0,1,1,0,58,0.000141,0,0
"讨",讨,,6,8,0.215694,0.224194,1116,1,1,2,1,1,2,0,57,0.000261,0,0.00115
"价",价,,8,8,0.218072,0.226436,183.860604,1,1,2,1,1,2,0,48,0.00024,0.00416,0.000046
"值",值,,8,7,0.278611,0.29628,2213.791665,5,4,9,4,4,8,0,48,0.000846,0.000903,0.007625
"瓜",瓜,,0,8,0.233215,0.242649,29.408914,1,1,2,1,1,2,0,48,0.000291,0.002389,0.000091
"例",例,,2,8,0.223268,0.232534,571.741815,7,4,11,5,2,7,0,48,0.00077,0.032111,0.000491
"半",半,,2,8,0.234391,0.245815,48.105772,1,1,2,1,1,2,0,48,0.000255,0.003081,0.000726
"富",富,,3,7,0.258761,0.27274,2823.684024,2,2,4,2,2,4,0,48,0.000549,0.000003,0.004464
"汗",汗,,3,9,0.201883,0.208911,12.07985,1,1,2,1,1,2,0,48,0.000374,0.000228,0.000062
"转",转,,6,8,0.252663,0.266311,1281.643157,4,4,8,3,2,5,0,48,0.00076,0.001206,0.005289
"运",运,,6,7,0.290365,0.311273,1466.374447,7,7,14,4,6,10,0,48,0.001074,0.003718,0.015772
"小",小,,6,8,0.199964,0.208105,444.28231,2,2,4,2,2,4,0,48,0.00039,0.003457,0.001118
"麦",麦,,8,8,0.191844,0.198637,3570.441778,3,3,6,3,2,5,0,48,0.000638,0.021799,0.000079
"食",食,,6,7,0.235729,0.246729,2219.802991,2,2,4,2,2,4,0,48,0.000467,0.001537,0.000341
"糖",糖,,6,8,0.245541,0.257176,163.949374,1,1,2,1,1,2,0,48,0.00034,0.000017,0.000513
"肥",肥,,6,7,0.244947,0.256799,0,1,1,2,1,1,2,0,48,0.00025,0.002933,0.002516
"货",货,,6,8,0.227226,0.237969,278.239636,4,5,9,3,2,5,0,48,0.000381,0.007894,0.000577
"完",完,,7,7,0.263718,0.278456,1791.504095,8,9,17,8,3,11,0,48,0.001074,0.018385,0.008006
"二",二,,5,7,0.281211,0.300218,585.198745,3,4,7,3,4,7,0,48,0.000641,0.004204,0.011533
"万",万,,5,7,0.2705,0.286827,3159.228736,5,5,10,5,5,10,0,48,0.000941,0.018108,0.009215
"吨",吨,,5,0,0,0,0,1,0,1,1,0,1,0,13,0.000301,0.000471,0
"千",千,,1,7,0.272616,0.28874,1931.02513,4,4,8,4,4,8,0,48,0.000643,0.01698,0.01012
"岗",岗,,2,8,0.2123,0.22076,12.889847,1,1,2,1,1,2,0,48,0.000233,0.004118,0.000343
"位",位,,2,7,0.269259,0.286684,1289.868774,4,2,6,4,2,6,0,48,0.000832,0.006711,0.009543
"坚",坚,,7,6,0.309293,0.333692,3383.797822,16,18,34,8,7,15,0,48,0.001019,0.041034,0.030396
"落",落,,2,8,0.246191,0.25954,126.517608,4,4,8,3,2,5,0,48,0.000446,0.005682,0.007408
"识",识,,0,7,0.276195,0.294905,887.194877,12,8,20,3,4,7,0,48,0.000723,0.008445,0.01209
"现",现,,2,6,0.314972,0.342735,5150.826983,17,17,34,7,16,23,0,48,0.000927,0.019906,0.047871
"步",步,,8,7,0.300377,0.32202,4346.813464,6,6,12,4,5,9,0,48,0.000724,0.026651,0.019456
"聚",聚,,7,8,0.203134,0.211011,2214.511676,2,2,4,2,2,4,0,48,0.000384,0.000998,0.001014
"焦",焦,,7,8,0.212058,0.21932,194.722501,1,1,2,1,1,2,0,48,0.000305,0.000052,0.000847
"民",民,,0,6,0.322627,0.350897,14088.241741,32,30,62,14,15,29,0,48,0.002359,0.043962,0.051394
"农",农,,5,7,0.254857,0.26836,361.451289,3,3,6,3,2,5,0,48,0.00059,0.013135,0.001652
"质",质,,6,7,0.296621,0.317431,319.600088,3,3,6,3,3,6,0,48,0.000581,0.004337,0.018324
"范",范,,0,7,0.256263,0.27019,1153.812371,5,5,10,3,3,6,0,48,0.000366,0.005954,0.012058
"工",工,,5,7,0.279169,0.296714,1952.921281,11,11,22,9,4,13,0,48,0.001141,0.03278,0.010238
"程",程,,8,7,0.3125,0.337243,1657.550437,11,8,19,4,6,10,0,48,0.0007,0.008337,0.038974
"福",福,,4,7,0.26322,0.27965,3907.775847,6,6,12,6,4,10,0,48,0.001225,0.025645,0.009982
"季",季,,7,8,0.232098,0.242262,6.881452,5,5,10,1,1,2,0,48,0.000229,0.001037,0.000303
"蔓",蔓,,7,1,1,1,1096,2,2,4,2,1,3,0,18,0.000339,0.003169,0
"延",延,,7,0,0,0,0,2,0,2,1,0,1,0,17,0.00043,0,0
"低",低,,5,8,0.244196,0.256802,1717.22916,4,4,8,3,3,6,0,48,0.000599,0.004119,0.004151
"迷",迷,,5,7,0.29781,0.318612,1796.88966,3,3,6,2,2,4,0,48,0.000517,0.000213,0.018612
"背",背,,5,7,0.269584,0.286423,1522.638443,7,6,13,5,4,9,0,48,0.000856,0.029566,0.011086
"景",景,,5,8,0.212098,0.219788,18.402696,4,2,6,2,1,3,0,48,0.000425,0.000839,0.00033
"样",样,,2,7,0.298288,0.319359,1256.650383,4,4,8,2,3,5,0,48,0.000328,0.006622,0.018978
"亮",亮,,0,8,0.230467,0.239772,10.527475,1,1,2,1,1,2,0,48,0.000234,0.000971,0.000099
"眼",眼,,0,7,0.299168,0.319808,2839.018035,4,4,8,4,3,7,0,48,0.000775,0.001945,0.018408
"绩",绩,,2,7,0.248828,0.260792,153.6974,2,2,4,1,2,3,0,48,0.000238,0.002651,0.001069
"易",易,,6,7,0.277501,0.295629,999.03611,7,6,13,3,6,9,0,48,0.000582,0.004909,0.008204
"劲",劲,,0,8,0.223268,0.233184,18.66247,2,2,4,1,2,3,0,48,0.000293,0.000762,0.002123
"韧",韧,,0,8,0.241761,0.253251,1356.364052,3,3,6,3,1,4,0,48,0.000637,0.005158,0.001618
"媒",媒,,2,7,0.258102,0.272483,334.40141,3,3,6,3,2,5,0,48,0.000687,0.003629,0.003776
"解",解,,7,7,0.306319,0.331189,8550.34019,13,14,27,9,9,18,0,48,0.001519,0.025136,0.044681
"读",读,,7,7,0.262291,0.277696,78.010636,1,1,2,1,1,2,0,48,0.000285,0.002285,0.00532
"复",复,,5,7,0.264531,0.280839,3232.181443,6,6,12,4,4,8,0,48,0.000711,0.024096,0.00998
"费",费,,7,8,0.243822,0.256809,1300.978353,3,3,6,2,3,5,0,48,0.000652,0.000014,0.005602
"扩",扩,,8,7,0.27162,0.287566,1378.519109,3,4,7,3,3,6,0,48,0.000426,0.007002,0.004215
"振",振,,7,8,0.201773,0.208656,2.527349,1,1,2,1,1,2,0,48,0.000355,0.001411,0.002303
"需",需,,8,7,0.274293,0.291832,2006.167388,8,7,15,7,4,11,0,48,0.00084,0.036416,0.009229
"子",子,,2,7,0.284439,0.303177,4831.251843,8,4,12,5,4,9,0,48,0.001397,0.001625,0.017747
"享",享,,2,7,0.255324,0.269795,113.443936,5,4,9,2,3,5,0,48,0.000554,0.002068,0.017636
"汽",汽,,8,8,0.214836,0.222676,2376.039709,2,2,4,2,1,3,0,48,0.000434,0.010582,0.000045
"车",车,,8,7,0.273351,0.289212,4340.261762,4,1,5,3,1,4,0,48,0.000873,0.000875,0.006536
"根",根,,1,7,0.280856,0.298597,4338.561645,10,17,27,8,5,13,0,48,0.001066,0.034084,0.005344
"德",德,,1,7,0.292882,0.311563,18.346769,1,2,3,1,2,3,0,48,0.000191,0.002922,0.009346
"奔",奔,,8,10,0.150478,0.153849,0,0,1,1,0,1,1,0,60,0.000141,0,0
"驰",驰,,8,9,0.176974,0.181746,1116,1,1,2,1,1,2,0,59,0.000261,0,0.000541
"销",销,,5,7,0.254044,0.268608,1179.450171,2,2,4,2,2,4,0,48,0.000464,0.001359,0.007021
"比",比,,0,7,0.256499,0.271903,276.569003,11,12,23,2,4,6,0,48,0.000562,0.007127,0.007357
"超",超,,8,7,0.260697,0.275086,129.473706,3,3,6,3,2,5,0,48,0.000393,0.023035,0.00483
"另",另,,2,7,0.259233,0.273458,0,0,1,1,0,1,1,0,61,0.000141,0,0.009609
"票",票,,7,1,1,1,1097,1,1,2,1,1,2,0,32,0.000369,0,0
"房",房,,7,0,0,0,0,1,0,1,1,0,1,0,31,0.000455,0,0
"机",机,,5,7,0.275037,0.291924,7140.66092,19,15,34,17,5,22,0,48,0.002565,0.047195,0.006311
"构",构,,5,6,0.303154,0.326129,1856.355867,11,9,20,2,9,11,0,48,0.000677,0.009963,0.028088
"北",北,,5,7,0.245865,0.257773,55.8146,2,2,4,2,2,4,0,48,0.000524,0.001495,0.005331
"势",势,,8,7,0.310326,0.335031,2303.467677,8,7,15,5,5,10,0,48,0.000977,0.002169,0.031435
"巨",巨,,8,7,0.257625,0.270856,0,1,1,2,1,1,2,0,48,0.000276,0.010026,0.004004
"潜",潜,,8,8,0.242128,0.253789,14.50527,1,1,2,1,1,2,0,48,0.00032,0.000472,0.002346
"循",循,,5,8,0.216043,0.224823,34.761257,4,4,8,2,1,3,0,48,0.000366,0.004617,0.00114
"环",环,,5,7,0.275309,0.293987,3960.78654,18,18,36,10,5,15,0,48,0.001422,0.022294,0.010735
"局",局,,7,7,0.281637,0.30075,3081.752055,9,7,16,6,6,12,0,48,0.000971,0.029209,0.014735
"键",键,,1,8,0.223986,0.23379,52.487468,2,2,4,1,2,3,0,48,0.000255,0.00475,0.004251
"节",节,,5,7,0.243982,0.256633,41.412433,1,1,2,1,1,2,0,48,0.000383,0.000549,0.002848
"改",改,,0,7,0.22548,0.236481,3098.165087,4,6,10,4,4,8,0,48,0.000515,0.032605,0.002214
"革",革,,0,8,0.232388,0.243836,125.002086,3,3,6,1,2,3,0,48,0.000251,0.000113,0.004267
"红",红,,5,8,0.246791,0.258032,4.13299,1,1,2,1,1,2,0,48,0.000168,0.004811,0.001537
"段",段,,0,7,0.245001,0.257132,1163.129747,5,5,10,2,2,4,0,48,0.000562,0.004108,0.002124
"间",间,,0,7,0.305145,0.329455,3606.800148,13,12,25,5,8,13,0,48,0.000876,0.008165,0.028552
"留",留,,1,8,0.222023,0.23181,646.338335,7,6,13,3,2,5,0,48,0.000636,0.01906,0.00125
"滋",滋,,4,8,0.213561,0.222403,1202.156122,3,3,6,3,1,4,0,48,0.000583,0.00631,0.000009
"盘",盘,,7,8,0.202286,0.210157,519.746689,2,2,4,2,1,3,0,48,0.000482,0.010651,0.000067
"甚",甚,,2,8,0.212908,0.221691,148.983609,2,7,9,2,1,3,0,48,0.000645,0.000241,0.000699
"捏",捏,,2,8,0.237791,0.248707,1646.633178,2,2,4,2,1,3,0,48,0.000494,0.000415,0.000903
"罪",罪,,2,7,0.265919,0.283447,6213.003512,8,8,16,5,7,12,0,48,0.001577,0.008263,0.008873
"名",名,,2,6,0.27868,0.297803,7008.17211,10,9,19,8,8,16,0,48,0.001401,0.0115,0.017834
"抓",抓,,5,8,0.231616,0.242628,1860.674109,2,3,5,2,3,5,0,48,0.00031,0.02119,0.000346
"捕",捕,,5,7,0.294195,0.314209,1935.354842,4,3,7,2,3,5,0,48,0.000688,0.000018,0.017822
"诉",诉,,0,7,0.259483,0.274286,51.589533,2,1,3,1,1,2,0,48,0.000293,0.00085,0.007879
"离",离,,3,7,0.246246,0.258714,133.306735,2,2,4,2,2,4,0,48,0.000419,0.00353,0.001381
"受",受,,0,7,0.267579,0.283508,3046.13359,12,12,24,11,6,17,0,48,0.001491,0.021818,0.007351
"执",执,,7,7,0.268158,0.284183,1021.063369,8,8,16,7,2,9,0,48,0.00122,0.012545,0.003767
"手",手,,0,7,0.279379,0.297461,2400.997071,4,4,8,3,4,7,0,48,0.000647,0.022828,0.010496
"脑",脑,,6,7,0.245001,0.256844,72.306812,1,1,2,1,1,2,0,48,0.000281,0.000185,0.002516
"检",检,,7,8,0.202323,0.210202,225.044964,2,2,4,2,1,3,0,48,0.000527,0.003382,0.000067
"扣",扣,,1,7,0.239785,0.251505,972.808845,4,4,8,4,3,7,0,48,0.000573,0.003332,0.001357
"述",述,,1,7,0.262662,0.2781,101.591612,3,3,6,1,2,3,0,48,0.000255,0.003081,0.003929
"露",露,,2,7,0.261124,0.277333,2515.132306,4,4,8,3,3,6,0,48,0.000695,0.000993,0.005039
"护",护,,3,7,0.31921,0.346122,1817.804474,17,14,31,3,11,14,0,48,0.000764,0.001306,0.052842
"权",权,,8,6,0.330273,0.35716,8625.560592,22,21,43,10,10,20,0,48,0.002181,0.041565,0.050006
"虚",虚,,0,8,0.198046,0.205156,170.618698,3,2,5,2,1,3,0,48,0.000486,0.021145,0.000541
"假",假,,0,7,0.246791,0.260391,1293.333844,3,2,5,2,2,4,0,48,0.000625,0.010582,0.002217
"侵",侵,,5,8,0.22783,0.237156,16.949053,1,1,2,1,1,2,0,48,0.000303,0.001564,0.000303
"害",害,,5,7,0.294818,0.315742,4427.242283,10,9,19,6,7,13,0,48,0.001679,0.005926,0.031514
"益",益,,8,7,0.253871,0.269408,206.767116,11,4,15,2,4,6,0,48,0.000478,0.005024,0.006592
"破",破,,4,7,0.254392,0.267277,1758.90301,6,8,14,5,3,8,0,48,0.000996,0.007596,0.004273
"坏",坏,,4,7,0.301189,0.323357,793.093381,7,6,13,2,4,6,0,48,0.0005,0.00179,0.03309
"予",予,,2,7,0.241238,0.252887,109.14796,4,4,8,3,1,4,0,48,0.000432,0.003737,0.003249
"谴",谴,,0,8,0.237234,0.247633,10.367331,1,2,3,1,1,2,0,48,0.000233,0.000484,0.001389
"敦",敦,,8,8,0.209981,0.217327,6.123796,2,3,5,2,1,3,0,48,0.000206,0.006116,0.001555
"针",针,,5,8,0.241447,0.254694,101.795397,2,2,4,2,1,3,0,48,0.000374,0.003034,0.006549
"采",采,,0,8,0.224889,0.235092,2326.15169,6,6,12,6,2,8,0,48,0.000774,0.013757,0.000409
"必",必,,8,7,0.2509,0.264617,2301.65609,5,5,10,3,3,6,0,48,0.000662,0.008512,0.001418
"逢",逢,,3,7,0.2509,0.263421,8.837939,1,1,2,1,1,2,0,48,0.000236,0.000971,0.010349
"蓬",蓬,,6,9,0.174056,0.178727,2187,1,6,7,1,1,2,0,48,0.00031,0.00078,0
"佩",佩,,6,8,0.210497,0.218164,2207,6,6,12,1,1,2,0,48,0.000404,0,0
"奥",奥,,6,7,0.266237,0.28196,2227,6,6,12,1,3,4,0,48,0.000485,0,0.006784
"尤",尤,,6,7,0.262291,0.277696,60.07022,1,1,2,1,1,2,0,48,0.000331,0.002914,0.00532
"老",老,,0,7,0.287223,0.306137,4853.432729,14,18,32,12,4,16,0,48,0.001699,0.039056,0.006678
"挝",挝,,0,6,0.321975,0.350628,1722.607255,15,14,29,1,13,14,0,48,0.000502,0.000342,0.054596
"山",山,,2,7,0.305815,0.328424,804.05197,2,2,4,2,2,4,0,48,0.000457,0.004729,0.026555
"枉",枉,,7,9,0.196199,0.202966,94.104855,1,1,2,1,1,2,0,48,0.000329,0.000073,0.000001
"心",心,,1,7,0.314616,0.341399,10915.903789,21,13,34,14,12,26,0,48,0.003134,0.04097,0.041784
"众",众,,1,7,0.255617,0.270641,1169.87125,3,4,7,2,3,5,0,48,0.000455,0.002636,0.010028
"唯",唯,,2,7,0.259302,0.273523,289.189455,2,2,4,2,1,3,0,48,0.000403,0.002871,0.009609
"陆",陆,,1,7,0.291808,0.31098,1852.245803,4,5,9,4,3,7,0,48,0.000755,0.005742,0.010104
"锁",锁,,1,7,0.290516,0.308783,0,2,2,4,1,1,2,0,48,0.000355,0.000517,0.009282
"既",既,,1,7,0.27409,0.291004,479.085325,4,4,8,4,3,7,0,48,0.000568,0.024271,0.009537
"略",略,,3,7,0.251579,0.266682,155.982363,6,5,11,1,4,5,0,48,0.00038,0.001432,0.003432
"热",热,,0,7,0.234836,0.246252,746.866829,2,2,4,2,2,4,0,48,0.000323,0.022147,0.001677
"梦",梦,,0,9,0.181389,0.187279,21.268965,1,1,2,1,1,2,0,48,0.000168,0.004811,0.00035
"想",想,,0,8,0.221362,0.23188,1365.517194,5,4,9,3,2,5,0,48,0.000414,0.006845,0.002334
"携",携,,0,8,0.218499,0.226974,75.197699,2,2,4,2,1,3,0,48,0.000329,0.01725,0.001168
"拓",拓,,0,8,0.241761,0.253251,39.998764,1,1,2,1,1,2,0,48,0.000278,0.000887,0.001618
"铁",铁,,0,7,0.243556,0.255262,80.109683,4,4,8,4,1,5,0,48,0.000864,0.006341,0.001301
"象",象,,5,9,0.186986,0.192904,15.598056,2,1,3,2,1,3,0,48,0.000529,0.000724,0.000839
"速",速,,7,7,0.247778,0.261373,64.484178,4,4,8,3,3,6,0,48,0.000604,0.003173,0.011762
"别",别,,2,7,0.307417,0.33095,1891.195035,12,12,24,8,7,15,0,48,0.00138,0.025704,0.026688
"底",底,,2,7,0.279589,0.299022,645.023253,4,4,8,2,4,6,0,48,0.000462,0.001906,0.015645
"写",写,,0,8,0.223313,0.232072,54.306528,1,1,2,1,1,2,0,48,0.000251,0.000113,0.001998
"代",代,,0,7,0.260149,0.274967,919.360774,5,4,9,5,4,9,0,48,0.000636,0.025065,0.003483
"历",历,,1,8,0.218157,0.226824,344.265713,2,4,6,2,1,3,0,48,0.000394,0.022868,0.000122
"崭",崭,,4,8,0.242233,0.253424,49.986082,1,1,2,1,1,2,0,48,0.000291,0.002389,0.004049
"姿",姿,,0,9,0.203951,0.212131,0,1,1,2,1,1,2,0,48,0.000264,0.019008,0.0013
"融",融,,3,7,0.283643,0.302306,969.986942,5,5,10,4,4,8,0,48,0.000583,0.033917,0.009431
"网",网,,2,7,0.246791,0.260829,8517.931507,24,24,48,13,3,16,0,48,0.002286,0.034313,0.005951
"络",络,,2,6,0.292574,0.315785,4222.272276,21,16,37,1,9,10,0,48,0.000789,0.000304,0.020676
"架",架,,2,8,0.23658,0.24737,1114.5,1,2,3,1,2,3,0,48,0.000299,0,0.00106
"脉",脉,,8,0,0,0,0,3,0,3,2,0,2,0,16,0.000444,0.00496,0
"秋",秋,,1,0,0,0,0,1,0,1,1,0,1,0,6,0.000278,0.000518,0
"欢",欢,,0,8,0.217731,0.226399,221.080783,3,3,6,3,1,4,0,48,0.000375,0.004928,0.000013
"迎",迎,,0,7,0.278055,0.296376,1931.036035,4,3,7,2,3,5,0,48,0.000627,0.000257,0.021419
"条",条,,6,7,0.267322,0.282648,896.779933,4,4,8,4,4,8,0,48,0.001212,0.0066,0.004615
"突",突,,2,7,0.24972,0.26353,1246.622696,2,2,4,2,2,4,0,48,0.000501,0.019057,0.003546
"瓶",瓶,,5,1,1,1,1096,1,1,2,1,1,2,0,39,0.000217,0.016357,0
"颈",颈,,5,0,0,0,0,1,0,1,1,0,1,0,38,0.000326,0,0
"姓",姓,,0,7,0.297254,0.31782,492.307675,2,2,4,1,2,3,0,48,0.000339,0.000037,0.01883
"踊",踊,,0,9,0.1646,0.168787,1106.489723,1,1,2,1,1,2,0,48,0.000212,0.010555,0
"跃",跃,,0,8,0.196857,0.203356,1126.489723,1,1,2,1,1,2,0,48,0.000322,0,0.000387
"因",因,,5,7,0.285239,0.306468,1683.911371,7,7,14,5,6,11,0,48,0.000852,0.019001,0.018703
"获",获,,5,8,0.234096,0.244432,40.750298,1,1,2,1,1,2,0,48,0.00022,0.002389,0.001159
"收",收,,5,7,0.247119,0.258977,92.425503,2,2,4,2,2,4,0,48,0.000344,0.005184,0.002085
"沿",沿,,2,9,0.164869,0.169084,0,0,1,1,0,1,1,0,62,0.000141,0,0.000092
"线",线,,2,8,0.19724,0.203797,1123.396151,2,1,3,2,1,3,0,48,0.000305,0.001797,0.000121
"居",居,,0,7,0.245379,0.257766,2299.192036,3,3,6,3,2,5,0,48,0.000623,0.00237,0.004551
"待",待,,0,6,0.306993,0.330269,484.353294,5,5,10,3,5,8,0,48,0.000498,0.006084,0.034497
"便",便,,5,8,0.246681,0.257913,36.650109,2,2,4,1,1,2,0,48,0.000264,0.019008,0.001537
"辈",辈,,2,8,0.221626,0.230315,98.149056,1,1,2,1,1,2,0,48,0.000303,0.004097,0.000083
"村",村,,7,7,0.255675,0.269534,367.913398,2,2,4,2,2,4,0,48,0.000514,0.019092,0.002772
"觉",觉,,0,8,0.234145,0.244477,16.417185,1,1,2,1,1,2,0,48,0.000261,0.002046,0.001159
"幸",幸,,4,8,0.208528,0.216508,24.727364,1,1,2,1,1,2,0,48,0.000249,0.001669,0.001312
"盼",盼,,0,9,0.191154,0.197301,35.164859,1,1,2,1,1,2,0,48,0.000268,0.005704,0.000293
"头",头,,0,8,0.236079,0.247349,1327.43848,4,2,6,4,2,6,0,48,0.000772,0.005722,0.002253
"简",简,,2,8,0.235979,0.246512,52.481658,1,1,2,1,1,2,0,48,0.000392,0.000329,0.000146
"单",单,,2,7,0.308522,0.332744,5477.129056,6,6,12,5,5,10,0,48,0.001009,0.002854,0.030063
"盛",盛,,6,7,0.227877,0.237194,4.438774,1,1,2,1,1,2,0,48,0.000174,0.002793,0.001057
"水",水,,2,8,0.244947,0.258233,5573.710206,7,7,14,7,4,11,0,48,0.001381,0.005299,0.002379
"畅",畅,,0,0,0,0,0,1,0,1,1,0,1,0,44,0.000243,0.003521,0
"后",后,,2,7,0.263843,0.279368,3272.878711,9,7,16,9,5,14,0,48,0.001948,0.01273,0.001988
"候",候,,0,8,0.218114,0.22762,1184.100798,2,2,4,2,2,4,0,48,0.000377,0.001776,0.002465
"烂",烂,,2,7,0.255675,0.269844,27.808207,1,1,2,1,1,2,0,48,0.000245,0.002319,0.002716
"夕",夕,,2,8,0.212868,0.221661,263.601678,1,1,2,1,1,2,0,48,0.000503,0.001416,0.000699
"听",听,,2,7,0.286338,0.306735,1076.884453,9,9,18,4,8,12,0,48,0.000663,0.0086,0.018694
"声",声,,0,8,0.239682,0.252566,2950.075767,9,7,16,9,5,14,0,48,0.001318,0.041866,0.002275
"吧",吧,,2,0,0,0,0,2,0,2,2,0,2,0,25,0.000492,0.00582,0
"短",短,,2,1,1,1,1096,1,1,2,1,1,2,0,43,0.000273,0.004192,0
"板",板,,2,0,0,0,0,1,0,1,1,0,1,0,42,0.000373,0,0
"桥",桥,,5,9,0.177718,0.18253,1094.3587,1,1,2,1,1,2,0,48,0.000259,0.002296,0
"梁",梁,,5,8,0.215918,0.22393,1114.3587,1,1,2,1,1,2,0,48,0.000361,0,0.002414
"妨",妨,,4,9,0.19201,0.199382,0,1,1,2,1,1,2,0,48,0.000243,0.003521,0.002605
"耍",耍,,7,9,0.20425,0.212481,19.640097,1,1,2,1,1,2,0,48,0.000251,0.001649,0.00033
"嘴",嘴,,7,9,0.181596,0.186697,1099.510823,1,1,2,1,1,2,0,48,0.00042,0.000768,0
"皮",皮,,7,8,0.22167,0.230345,1119.510823,1,1,2,1,1,2,0,48,0.000498,0,0.000083
"挑",挑,,3,8,0.238963,0.251099,3957.746808,5,6,11,5,3,8,0,48,0.000902,0.012131,0.000866
"或",或,,5,7,0.268869,0.286274,2648.108323,5,5,10,5,5,10,0,48,0.001089,0.018651,0.012664
"谁",谁,,0,7,0.27315,0.289347,98.491586,2,1,3,2,1,3,0,48,0.000352,0.016535,0.006369
"祉",祉,,4,8,0.232728,0.243945,92.165186,2,1,3,1,1,2,0,48,0.000402,0.000511,0.008853
"族",族,,5,7,0.306319,0.330361,2829.17708,10,9,19,4,8,12,0,48,0.00066,0.004582,0.03088
"寻",寻,,8,8,0.221846,0.232181,2709.001519,4,4,8,4,3,7,0,48,0.000699,0.014327,0.000309
"。",。,,7,0,0,0,0,2,0,2,2,0,2,0,33,0.000545,0.003298,0
"连",连,,3,7,0.254276,0.267493,679.781406,2,2,4,2,2,4,0,48,0.0004,0.010439,0.00529
"摒",摒,,2,8,0.20369,0.211037,2601.580026,2,2,4,2,1,3,0,48,0.000323,0.002225,0.000001
"弃",弃,,2,7,0.2555,0.270073,5321.263087,3,3,6,2,3,5,0,48,0.00071,0.000014,0.003336
"陈",陈,,2,9,0.186361,0.191818,1097.335448,1,1,2,1,1,2,0,48,0.000342,0.000171,0
"旧",旧,,2,8,0.228718,0.238344,1117.335448,1,1,2,1,1,2,0,48,0.000432,0,0.000827
"冷",冷,,3,8,0.236982,0.247676,700.8049,4,4,8,4,1,5,0,48,0.000738,0.031818,0.000861
"思",思,,3,8,0.218114,0.227603,33.485613,3,3,6,1,1,2,0,48,0.00038,0.001432,0.001222
"零",零,,5,7,0.268804,0.285563,0,1,1,2,1,1,2,0,48,0.000276,0.010026,0.009244
"博",博,,3,9,0.1769,0.181774,1094,1,1,2,1,1,2,0,48,0.000276,0.010026,0
"弈",弈,,3,8,0.214712,0.222857,1114,1,1,2,1,1,2,0,48,0.000376,0,0.001078
"俄",俄,,1,7,0.258521,0.272389,491.379664,1,2,3,1,2,3,0,48,0.000471,0.003593,0.005391
"而",而,,5,6,0.29957,0.322018,1305.813186,6,7,13,4,6,10,0,48,0.000629,0.008246,0.017259
"轨",轨,,7,7,0.297492,0.318463,83.157179,2,2,4,2,2,4,0,48,0.000351,0.004958,0.017876
"贯",贯,,2,7,0.302332,0.324956,180.084746,8,8,16,1,6,7,0,48,0.000303,0.004097,0.025326
"选",选,,8,7,0.257387,0.272163,2683.228087,5,4,9,3,4,7,0,48,0.000472,0.01027,0.01154
"拿",拿,,5,7,0.271092,0.286468,101.535699,4,4,8,2,2,4,0,48,0.000628,0.004823,0.014353
"棱",棱,,2,9,0.179781,0.184717,1096.589149,1,1,2,1,1,2,0,48,0.000226,0.007391,0
"镜",镜,,2,8,0.219014,0.22732,1116.589149,1,1,2,1,1,2,0,48,0.000334,0,0.000621
"窃",窃,,2,7,0.2679,0.284973,1158.937435,8,8,16,5,3,8,0,48,0.000804,0.022274,0.006084
"指",指,,0,8,0.240977,0.252356,128.303215,4,4,8,3,2,5,0,48,0.000443,0.003377,0.001399
"讽",讽,,0,9,0.197695,0.204295,1094,1,1,2,1,1,2,0,48,0.000279,0.005035,0
"刺",刺,,0,8,0.246191,0.258513,1114,1,1,2,1,1,2,0,48,0.000379,0,0.002887
"味",味,,0,7,0.295364,0.315324,0,1,1,2,1,1,2,0,48,0.000279,0.002747,0.017311
"闻",闻,,4,8,0.232922,0.244663,4436,3,2,5,2,2,4,0,48,0.000659,0.002741,0.008876
"攻",攻,,7,7,0.241918,0.253946,403.898058,8,8,16,4,2,6,0,48,0.000647,0.019631,0.002141
"击",击,,7,7,0.27096,0.289673,1659.92909,7,6,13,3,4,7,0,48,0.001009,0.000829,0.012441
"己",己,,0,7,0.295364,0.315324,390.605186,4,3,7,2,1,3,0,48,0.000529,0.002739,0.017311
"软",软,,6,8,0.184419,0.189628,1097.25,2,2,4,2,1,3,0,48,0.000305,0.020458,0
"硬",硬,,6,7,0.225937,0.234886,1117.25,2,2,4,1,1,2,0,48,0.000401,0,0.00015
"件",件,,6,6,0.291579,0.311151,4547.074432,7,4,11,5,4,9,0,48,0.001371,0.002939,0.012215
"占",占,,1,6,0.268287,0.284395,1156.325919,2,2,4,2,2,4,0,48,0.000433,0.002844,0.006377
"掌",掌,,5,8,0.209115,0.216662,1103.328825,2,2,4,2,1,3,0,48,0.000327,0.00682,0
"握",握,,5,7,0.264155,0.279142,1123.328825,2,2,4,1,2,3,0,48,0.000419,0,0.002847
"洞",洞,,6,7,0.217519,0.226233,2223,2,1,3,1,1,2,0,48,0.000501,0,0.002453
"拥",拥,,1,7,0.259423,0.274241,25.79114,1,1,2,1,1,2,0,48,0.000255,0.003081,0.007879
"登",登,,1,8,0.210775,0.219387,9.687058,1,1,2,1,1,2,0,48,0.000272,0.000567,0.00019
"列",列,,5,7,0.239219,0.249966,47.599384,2,1,3,2,1,3,0,48,0.000408,0.00233,0.000386
"犯",犯,,2,8,0.210219,0.218498,1393.743327,4,4,8,4,1,5,0,48,0.000876,0.022013,0.000423
"组",组,,1,7,0.236279,0.248057,1556.65186,10,10,20,9,2,11,0,48,0.001529,0.013446,0.004185
"织",织,,1,7,0.284875,0.306272,917.994735,10,9,19,2,9,11,0,48,0.000996,0.000622,0.020998
"告",告,,7,8,0.236329,0.248297,1178.082458,5,3,8,2,3,5,0,48,0.000506,0.000098,0.00533
"航",航,,2,8,0.220792,0.22982,618.512381,1,2,3,1,2,3,0,48,0.000369,0.000001,0.000281
"空",空,,2,9,0.196372,0.203482,2298.222798,2,2,4,2,2,4,0,48,0.000536,0.000014,0.000021
"科",科,,7,8,0.199321,0.207747,1111.828489,4,5,9,4,2,6,0,48,0.000693,0.016984,0.00177
"石",石,,7,8,0.203795,0.210887,0,0,1,1,0,1,1,0,64,0.000141,0,0
"油",油,,7,7,0.255729,0.269427,1116,1,1,2,1,1,2,0,63,0.000261,0,0.001237
"渗",渗,,2,9,0.19254,0.198918,2.284314,1,1,2,1,1,2,0,48,0.000216,0.001058,0.000226
"显",显,,0,7,0.285824,0.304644,456.589883,4,4,8,3,4,7,0,48,0.000678,0.004715,0.011401
"见",见,,0,6,0.293498,0.315919,2857.138736,8,5,13,5,5,10,0,48,0.001007,0.005912,0.024155
"谎",谎,,0,8,0.215002,0.223717,2599.107246,3,4,7,2,2,4,0,48,0.000545,0.019057,0.000615
"遍",遍,,0,7,0.259786,0.275187,1156.49529,3,4,7,2,3,5,0,48,0.000552,0.000519,0.00716
"帝",帝,,3,7,0.290516,0.308783,48.53911,1,1,2,1,1,2,0,48,0.000236,0.000971,0.009282
"即",即,,4,9,0.189658,0.1966,1135.564725,3,3,6,1,2,3,0,48,0.000266,0.002778,0.000366
"贼",贼,,0,7,0.297889,0.318911,4693.302538,7,6,13,5,3,8,0,48,0.00121,0.018392,0.019457
"喊",喊,,0,9,0.186798,0.192179,1094,3,3,6,1,1,2,0,48,0.000484,0.000995,0
"捉",捉,,0,8,0.229613,0.239069,1114,3,3,6,1,1,2,0,48,0.000553,0,0.000941
"戏",戏,,0,0,0,0,0,2,0,2,1,0,1,0,9,0.000215,0.000541,0
"抗",抗,,7,8,0.213356,0.222229,30.006881,1,2,3,1,1,2,0,48,0.000279,0.000537,0.000042
"债",债,,5,7,0.254857,0.268234,1952.574099,16,15,31,13,3,16,0,48,0.001572,0.046679,0.004851
"缓",缓,,5,7,0.252434,0.266248,3575.704538,5,5,10,5,3,8,0,48,0.000904,0.019769,0.005889
"倡",倡,,7,8,0.240977,0.25242,1851.35791,5,5,10,4,1,5,0,48,0.001071,0.007307,0.000566
"照",照,,8,7,0.258401,0.272761,1265.551014,2,2,4,2,2,4,0,48,0.000511,0.000006,0.015376
"处",处,,7,7,0.283283,0.301332,5358.564721,11,10,21,9,4,13,0,48,0.001779,0.017224,0.01024
"私",私,,5,8,0.248551,0.260783,88.218381,2,2,4,2,2,4,0,48,0.000315,0.002034,0.003524
"昨",昨,,2,8,0.220312,0.228654,10.874642,1,2,3,1,1,2,0,48,0.000279,0.000754,0.00028
"特",特,,7,7,0.257327,0.271164,950.361966,5,6,11,5,3,8,0,48,0.001011,0.013062,0.002065
"快",快,,7,8,0.229329,0.240236,24.074004,2,1,3,2,1,3,0,48,0.000353,0.00213,0.003014
"累",累,,2,8,0.218995,0.227296,0,0,1,1,0,1,1,0,65,0.000141,0,0.000621
"银",银,,7,7,0.255793,0.26949,35.937809,3,3,6,1,1,2,0,48,0.000201,0.003139,0.001237
"排",排,,7,7,0.2463,0.258913,611.406228,6,3,9,4,3,7,0,48,0.000853,0.004408,0.001088
"升",升,,5,7,0.27295,0.29028,295.250314,3,3,6,2,3,5,0,48,0.000504,0.002324,0.011129
"币",币,,6,8,0.210695,0.219181,871.589325,3,3,6,2,2,4,0,48,0.000437,0.002658,0.003231
"预",预,,6,8,0.231761,0.242986,1735.414407,3,4,7,3,4,7,0,48,0.000681,0.004376,0.001366
"测",测,,6,0,0,0,0,1,0,1,1,0,1,0,11,0.000286,0.00007,0
"映",映,,2,7,0.255734,0.269889,0,2,2,4,1,1,2,0,48,0.00026,0.001101,0.002716
"份",份,,2,7,0.276812,0.295898,1579.882556,4,3,7,4,3,7,0,48,0.001211,0.004778,0.018567
"难",难,,3,7,0.30062,0.322693,253.692469,3,3,6,3,3,6,0,48,0.000467,0.007971,0.023112
"贵",贵,,3,0,0,0,0,1,0,1,1,0,1,0,28,0.000337,0.000994,0
"拉",拉,,8,7,0.256381,0.27009,0,1,1,2,1,1,2,0,48,0.000264,0.019008,0.002608
"广",广,,8,7,0.258761,0.273248,2468.202356,5,5,10,5,3,8,0,48,0.000561,0.035637,0.004025
"阔",阔,,8,9,0.198187,0.204585,5.760714,1,1,2,1,1,2,0,48,0.0003,0.000206,0.002599
"遇",遇,,5,8,0.228577,0.237888,160.124833,2,1,3,2,1,3,0,48,0.000608,0.002382,0.000332
"添",添,,2,7,0.234194,0.244659,29.909872,1,1,2,1,1,2,0,48,0.000304,0.000384,0.001519
"西",西,,4,7,0.278889,0.29726,1507.546678,11,12,23,6,4,10,0,48,0.000781,0.026985,0.008217
"牧",牧,,0,7,0.244089,0.255584,33.906146,1,1,2,1,1,2,0,48,0.000228,0.001254,0.002249
"请",请,,8,8,0.218499,0.226653,48.902394,1,1,2,1,1,2,0,48,0.000275,0.002629,0.000189
"帮",帮,,8,8,0.216295,0.226371,221.164339,6,6,12,6,2,8,0,48,0.000751,0.019166,0.001239
"找",找,,8,7,0.256794,0.271593,2823.450412,4,4,8,3,3,6,0,48,0.000668,0.002316,0.001315
"牦",牦,,8,8,0.22839,0.237506,1094,1,1,2,1,1,2,0,48,0.00033,0.000067,0
"牛",牛,,8,7,0.295599,0.315473,1114,1,1,2,1,1,2,0,48,0.000422,0,0.017311
"士",士,,6,6,0.306909,0.33012,2135.551823,5,5,10,3,5,8,0,48,0.000592,0.025717,0.023136
"兵",兵,,6,8,0.229613,0.239069,563.009689,1,1,2,1,1,2,0,48,0.000242,0.001183,0.000011
"失",失,,6,7,0.263905,0.277314,124.003935,3,2,5,1,1,2,0,48,0.000408,0.00069,0.007737
"队",队,,7,8,0.210656,0.218615,15.308446,1,1,2,1,1,2,0,48,0.000271,0.001142,0.002193
"印",印,,5,7,0.284221,0.30202,902.41513,5,7,12,4,2,6,0,48,0.000556,0.00516,0.003417
"搜",搜,,8,9,0.181685,0.187385,0,1,1,2,1,1,2,0,48,0.00029,0.000937,0.000733
"救",救,,8,9,0.190078,0.19656,28.444984,1,1,2,1,1,2,0,48,0.000339,0.000016,0.000335
"医",医,,1,8,0.217731,0.226236,90.981437,1,1,2,1,1,2,0,48,0.000234,0.004833,0.00031
"移",移,,6,7,0.234786,0.245642,47.304509,2,2,4,2,1,3,0,48,0.000534,0.013118,0.002505
"紧",紧,,5,8,0.250787,0.26431,253.902077,2,2,4,2,2,4,0,48,0.000324,0.003413,0.003909
"七",七,,8,9,0.189658,0.195592,55.758903,1,1,2,1,1,2,0,48,0.000432,0.000516,0.000232
"轮",轮,,8,8,0.233851,0.244637,1249.329313,2,2,4,2,2,4,0,48,0.000567,0.004532,0.002097
"级",级,,7,7,0.265034,0.279885,61.377982,3,3,6,2,2,4,0,48,0.000239,0.008684,0.002429
"宁",宁,,7,0,0,0,0,1,0,1,1,0,1,0,29,0.000481,0.000591,0
"湾",湾,,5,7,0.304063,0.326421,548.022024,12,12,24,2,7,9,0,48,0.00054,0.000857,0.030345
"土",土,,6,6,0.269454,0.286457,339.393349,2,2,4,1,2,3,0,48,0.000682,0.000097,0.008849
"割",割,,2,7,0.295364,0.315324,121.225884,2,2,4,1,1,2,0,48,0.000248,0.001406,0.017311
"普",普,,0,8,0.206329,0.214045,538.159602,2,2,4,2,1,3,0,48,0.000322,0.023528,0.000027
"官",官,,5,6,0.292267,0.31136,978.870418,7,6,13,6,4,10,0,48,0.000696,0.033219,0.00586
"往",往,,0,7,0.299329,0.321055,604.469568,4,4,8,4,4,8,0,48,0.00061,0.018671,0.020437
"恪",恪,,8,7,0.233802,0.243698,200.198563,2,2,4,2,1,3,0,48,0.000377,0.007134,0.000109
"慎",慎,,8,8,0.229377,0.240281,13.196925,1,2,3,1,1,2,0,48,0.000255,0.003081,0.003014
"妥",妥,,7,8,0.225891,0.235305,1475.92698,5,6,11,5,2,7,0,48,0.00092,0.006372,0.000889
"善",善,,7,7,0.256912,0.271454,953.404534,6,6,12,2,4,6,0,48,0.000642,0.000159,0.007219
"桑",桑,,1,9,0.186299,0.192471,3301.388413,3,3,6,2,2,4,0,48,0.000442,0.000923,0
"尼",尼,,1,8,0.2182,0.227065,1029.819778,1,1,2,1,1,2,0,48,0.000329,0,0.000055
"祝",祝,,6,7,0.257863,0.271574,1395.627537,2,2,4,2,2,4,0,48,0.000355,0.000957,0.004014
"顺",顺,,5,8,0.246791,0.258032,50.736199,2,2,4,2,1,3,0,48,0.00033,0.002503,0.001537
"呼",呼,,5,8,0.203393,0.211339,1100.654075,2,2,4,2,2,4,0,48,0.000296,0.014964,0.002147
"吁",吁,,1,8,0.237892,0.248773,540.341487,1,1,2,1,1,2,0,48,0.000267,0.00011,0.006101
"尊",尊,,8,8,0.229329,0.240236,96.182757,3,3,6,3,1,4,0,48,0.000587,0.004484,0.003014
"结",结,,5,8,0.20698,0.215099,45.803078,1,1,2,1,1,2,0,48,0.000242,0.000113,0.000984
"张",张,,5,7,0.308267,0.329957,682.468034,2,2,4,2,2,4,0,48,0.00045,0.00058,0.023847
"风",风,,1,8,0.208606,0.217053,1659.267294,3,3,6,3,2,5,0,48,0.000545,0.021131,0.000762
"俗",俗,,1,9,0.184756,0.190943,387.931049,2,2,4,1,1,2,0,48,0.000373,0.000039,0.000033
"惯",惯,,1,7,0.269129,0.28631,1015.02799,2,2,4,1,2,3,0,48,0.000341,0.000056,0.010758
"宗",宗,,1,8,0.198399,0.206016,249.189033,4,4,8,3,1,4,0,48,0.000543,0.029584,0.000514
"仰",仰,,1,9,0.177689,0.182896,114.428782,2,1,3,1,1,2,0,48,0.000252,0.002129,0.00003
"彻",彻,,7,8,0.242972,0.255696,1829.900773,5,5,10,4,4,8,0,48,0.000837,0.007729,0.000458
"毫",毫,,0,8,0.228156,0.238912,83.421649,2,3,5,2,1,3,0,48,0.000546,0.002623,0.003054
"滥",滥,,5,7,0.237285,0.248074,84.521821,1,1,2,1,1,2,0,48,0.000217,0.016357,0.001232
"肆",肆,,8,7,0.270238,0.288174,2863.473187,4,6,10,2,4,6,0,48,0.000311,0.014715,0.008406
"剥",剥,,8,8,0.204737,0.211887,1098.840383,1,2,3,1,1,2,0,48,0.000277,0.00019,0
"夺",夺,,8,7,0.257209,0.271224,1118.840383,2,2,4,1,2,3,0,48,0.000377,0,0.014617
"迫",迫,,0,7,0.252205,0.26549,145.846714,4,4,8,2,3,5,0,48,0.000367,0.002088,0.005829
"售",售,,2,8,0.225891,0.235979,2233.849816,2,2,4,2,2,4,0,48,0.000713,0.00387,0.002056
"股",股,,2,8,0.216968,0.225972,79.401361,1,1,2,1,1,2,0,48,0.000444,0.000105,0.000244
"扭",扭,,4,9,0.190794,0.197004,39.383223,1,1,2,1,1,2,0,48,0.00025,0.002991,0.000141
"曲",曲,,4,8,0.23553,0.246903,3018.139807,3,2,5,3,2,5,0,48,0.000648,0.002761,0.001298
"尽",尽,,7,7,0.297175,0.318522,1308.971594,2,4,6,2,4,6,0,48,0.000259,0.003313,0.017594
"睹",睹,,0,0,0,0,0,1,0,1,1,0,1,0,46,0.000447,0.000662,0
"操",操,,0,9,0.166145,0.171026,1952.071082,2,2,4,2,2,4,0,48,0.00029,0.017683,0.000045
"纵",纵,,0,8,0.198859,0.205745,1405.919243,2,2,4,2,2,4,0,48,0.000354,0.000885,0.00019
"汇",汇,,2,8,0.220312,0.228828,497.779479,2,2,4,2,1,3,0,48,0.000477,0.000175,0.000028
"率",率,,2,7,0.282278,0.300525,2585.996839,4,4,8,3,4,7,0,48,0.000953,0.000539,0.012213
"稽",稽,,0,8,0.22811,0.238088,51.363439,2,1,3,2,1,3,0,48,0.000362,0.005717,0.001769
"威",威,,8,7,0.290516,0.308783,42.541588,2,1,3,1,1,2,0,48,0.000327,0.002558,0.009282
"均",均,,8,8,0.244732,0.257556,609.043028,3,3,6,3,3,6,0,48,0.000527,0.00333,0.00239
"估",估,,5,8,0.221758,0.231541,282.523411,3,2,5,3,2,5,0,48,0.000644,0.001786,0.002266
"血",血,,8,1,1,1,261.668062,1,1,2,1,1,2,0,45,0.000264,0.019008,0.000254
"贷",贷,,1,7,0.273754,0.290154,1151.197875,2,2,4,2,2,4,0,48,0.000315,0.003565,0.006553
"丰",丰,,3,8,0.205682,0.21284,1005.569864,1,1,2,1,1,2,0,48,0.000264,0.019008,0
"杆",杆,,0,8,0.206941,0.214034,3.836162,1,1,2,1,1,2,0,48,0.000361,0.000438,0.001721
"泛",泛,,8,8,0.203802,0.211615,233.660614,2,2,4,1,2,3,0,48,0.0003,0.000206,0.002773
"令",令,,6,7,0.272217,0.287499,2518.738875,5,4,9,4,3,7,0,48,0.000859,0.00176,0.011054
"置",置,,2,7,0.238554,0.251151,194.13396,3,2,5,3,2,5,0,48,0.000734,0.005838,0.002961
"纯",纯,,5,8,0.219445,0.228498,2189.912454,4,4,8,3,2,5,0,48,0.000588,0.005187,0
"粹",粹,,5,7,0.273284,0.289466,741.524084,1,1,2,1,1,2,0,48,0.000391,0,0.006369
"酸",酸,,1,10,0.162205,0.166221,2187,1,1,2,1,1,2,0,48,0.000212,0.010555,0
"葡",葡,,1,9,0.193442,0.199557,2207,1,1,2,1,1,2,0,48,0.000322,0,0
"萄",萄,,1,8,0.239579,0.250704,2227,1,1,2,1,1,2,0,48,0.000415,0,0.002096
"宏",宏,,3,8,0.214671,0.222827,2.461111,1,1,2,1,1,2,0,48,0.000166,0.001746,0.001078
"素",素,,2,8,0.217434,0.22625,10.788544,1,1,2,1,1,2,0,48,0.000262,0.000957,0.000324
"款",款,,1,7,0.211776,0.21966,18.991867,1,1,2,1,1,2,0,48,0.000275,0.000335,0.000145
"困",困,,7,7,0.292805,0.313165,284.744552,9,5,14,2,5,7,0,48,0.000379,0.003874,0.02145
"逼",逼,,0,8,0.203245,0.210089,15.816845,1,1,2,1,1,2,0,48,0.000243,0.003521,0.002388
"渠",渠,,5,8,0.237032,0.24835,10.697355,2,2,4,1,1,2,0,48,0.000274,0.001859,0.000566
"减",减,,7,7,0.239733,0.251435,1267.591543,11,11,22,9,2,11,0,48,0.000964,0.017486,0.000603
"集",集,,5,7,0.23963,0.251142,750.854058,2,2,4,2,2,4,0,48,0.000399,0.016662,0.001541
"暂",暂,,5,8,0.201737,0.208814,22.540717,1,1,2,1,1,2,0,48,0.000242,0.000113,0.001011
"贫",贫,,7,6,0.312763,0.338924,6704.721845,27,26,53,10,15,25,0,48,0.002048,0.010227,0.040369
"穷",穷,,0,7,0.29044,0.308708,55.034606,2,1,3,2,1,3,0,48,0.000359,0.005586,0.009282
"降",降,,8,9,0.196441,0.203044,232.115007,1,1,2,1,1,2,0,48,0.000294,0.00287,0.000211
"摆",摆,,7,7,0.274563,0.291066,285.107575,5,6,11,5,2,7,0,48,0.000714,0.034608,0.008691
"那",那,,0,7,0.242076,0.253914,1310.453634,2,3,5,2,2,4,0,48,0.000363,0.028648,0.000594
"里",里,,0,7,0.295364,0.315324,500.833081,1,1,2,1,1,2,0,48,0.000295,0.00003,0.017311
"歪",歪,,4,9,0.190761,0.196975,41.1998,1,1,2,1,1,2,0,48,0.000184,0.001857,0.000141
"编",编,,2,8,0.23774,0.248662,30.83956,2,2,4,2,1,3,0,48,0.000337,0.010968,0.000903
"躬",躬,,0,7,0.232874,0.243466,18.108787,1,1,2,1,1,2,0,48,0.00026,0.001101,0.005026
"省",省,,0,7,0.235879,0.245911,359.721627,2,1,3,2,1,3,0,48,0.000564,0.001133,0.000115
"藏",藏,,4,7,0.256912,0.273406,608.631324,11,11,22,4,5,9,0,48,0.000636,0.012456,0.015011
"属",属,,5,7,0.252034,0.265394,373.388371,3,3,6,1,2,3,0,48,0.000391,0,0.010965
"容",容,,0,7,0.245703,0.257025,2859.556785,2,2,4,2,2,4,0,48,0.000393,0.00353,0.005017
"弄",弄,,0,0,0,0,0,1,0,1,1,0,1,0,36,0.000265,0.000002,0
"旨",旨,,5,7,0.273328,0.289177,0,0,2,2,0,1,1,0,66,0.000141,0,0.006536
"亡",亡,,6,7,0.232922,0.243051,907.462013,3,2,5,2,1,3,0,48,0.000368,0.000884,0.004786
"纲",纲,,6,8,0.20698,0.214147,17.851742,1,1,2,1,1,2,0,48,0.000279,0.005035,0.00311
"妄",妄,,5,8,0.21607,0.225001,0,0,1,1,0,1,1,0,67,0.000141,0,0.00099
"图",图,,5,7,0.275377,0.294585,5212.122686,6,6,12,5,6,11,0,48,0.001585,0.019346,0.014202
"裂",裂,,8,7,0.254799,0.269379,43.933188,4,4,8,1,3,4,0,48,0.000248,0.001406,0.005994
"它",它,,2,7,0.27409,0.290833,112.501297,1,2,3,1,2,3,0,48,0.00028,0.000669,0.007309
"宪",宪,,8,7,0.244464,0.257072,0,1,1,2,1,1,2,0,48,0.000217,0.016357,0.00253
"洛",洛,,1,10,0.157153,0.161098,2308.279631,1,2,3,1,1,2,0,48,0.000245,0.003761,0.000047
"孙",孙,,1,8,0.219531,0.227798,1196.568635,2,2,4,1,1,2,0,48,0.000329,0,0.001743
"尾",尾,,7,7,0.295521,0.315443,545.360095,1,1,2,1,1,2,0,48,0.000319,0.000023,0.017311
"罗",罗,,1,7,0.265793,0.282214,496.167857,3,3,6,3,3,6,0,48,0.000722,0.000914,0.007974
"号",号,,1,0,0,0,0,2,0,2,1,0,1,0,30,0.000252,0.002129,0
"捍",捍,,0,8,0.199392,0.206512,84.461401,1,1,2,1,1,2,0,48,0.000234,0.002227,0.000019
"疆",疆,,4,7,0.309207,0.336182,1432.731421,18,18,36,2,13,15,0,48,0.000483,0.003577,0.040513
"久",久,,0,8,0.223671,0.23377,86.658683,1,1,2,1,1,2,0,48,0.000243,0.003521,0.00157
4,4,,2,8,0.242814,0.25535,1640.274744,2,2,4,2,2,4,0,48,0.000519,0.005054,0.00252
8,8,,2,8,0.242655,0.254678,0,1,1,2,1,1,2,0,48,0.000362,0.000129,0.002514
"挺",挺,,0,8,0.227365,0.237549,55.188036,1,1,2,1,1,2,0,48,0.00041,0.00036,0.001067
"赴",赴,,4,8,0.242181,0.253379,47.92239,1,1,2,1,1,2,0,48,0.000295,0.005205,0.004049
"访",访,,0,8,0.243025,0.25547,516.733534,3,1,4,2,1,3,0,48,0.000731,0.000163,0.006756
"亲",亲,,2,7,0.24484,0.257151,13.780869,1,2,3,1,2,3,0,48,0.000156,0.004302,0.00061
"纷",纷,,0,8,0.207127,0.214639,0,1,2,3,1,2,3,0,68,0.000141,0,0.00001
"称",称,,0,7,0.261002,0.276079,4600.755889,5,3,8,4,3,7,0,48,0.000948,0.00019,0.018352
"恐",恐,,5,7,0.268934,0.285787,79.19755,1,1,2,1,1,2,0,48,0.00026,0.001101,0.009244
"状",状,,7,9,0.182279,0.187845,117.48862,3,3,6,3,1,4,0,48,0.000391,0.002641,0.000073
"越",越,,2,7,0.268675,0.285072,932.474003,4,4,8,3,4,7,0,48,0.000668,0.007874,0.007576
"像",像,,2,8,0.229613,0.239132,11.765346,1,1,2,1,1,2,0,48,0.000273,0.004192,0.00143
"撒",撒,,0,9,0.177097,0.182159,55.594332,2,2,4,2,1,3,0,48,0.000331,0.004852,0.000975
"欺",欺,,0,8,0.212058,0.220021,1204.622771,5,5,10,2,1,3,0,48,0.000466,0.001492,0
"骗",骗,,0,7,0.268869,0.285189,1224.622771,5,4,9,1,3,4,0,48,0.000537,0,0.016019
"偷",偷,,2,8,0.224166,0.23383,242.058012,3,3,6,3,2,5,0,48,0.000645,0.00604,0.001542
"炮",炮,,0,8,0.240095,0.251361,48.133954,1,1,2,1,1,2,0,48,0.000323,0.000175,0.000573
"劳",劳,,8,7,0.256381,0.27009,116.144842,5,5,10,4,1,5,0,48,0.00063,0.024603,0.002608
"凭",凭,,2,10,0.16426,0.168672,2266.916799,1,1,2,1,1,2,0,48,0.000279,0.005035,0.000001
"择",择,,8,8,0.202396,0.209067,1095.771287,1,1,2,1,1,2,0,48,0.000242,0.00059,0
"职",职,,8,7,0.253467,0.266133,1115.771287,1,1,2,1,1,2,0,48,0.000347,0,0.000676
"限",限,,0,8,0.25192,0.264752,356.808287,6,6,12,5,2,7,0,48,0.000998,0.011577,0.000876
"语",语,,3,8,0.215876,0.224898,1201.774719,2,2,4,2,2,4,0,48,0.000617,0.000587,0.00116
"字",字,,0,8,0.205492,0.213376,413.368904,3,2,5,2,2,4,0,48,0.00042,0.000918,0.000209
"依",依,,8,7,0.244464,0.257072,330.172313,8,8,16,8,1,9,0,48,0.000976,0.024869,0.00253
"良",良,,8,7,0.246791,0.258986,12.10099,1,1,2,1,1,2,0,48,0.000268,0.005704,0.001722
"让",让,,0,7,0.23619,0.246315,0,0,2,2,0,1,1,0,69,0.000141,0,0.000379
"舒",舒,,5,8,0.239476,0.250629,2.238804,2,2,4,1,1,2,0,48,0.00022,0.00518,0.002096
"吾",吾,,3,8,0.20258,0.209842,35.07159,1,1,2,1,1,2,0,48,0.000321,0.000665,0.000053
"群",群,,1,8,0.203765,0.211334,2.515675,1,1,2,1,1,2,0,48,0.000211,0.00158,0.000135
"障",障,,3,7,0.237386,0.248151,38.584769,3,2,5,1,2,3,0,48,0.000402,0.000638,0.001505
"哪",哪,,2,8,0.243078,0.2543,25.655178,1,1,2,1,1,2,0,48,0.00022,0.002389,0.000525
"滑",滑,,2,8,0.220269,0.228609,26.539719,1,1,2,1,1,2,0,48,0.000212,0.010555,0.00028
"又",又,,0,9,0.183751,0.189497,12.363446,1,1,2,1,1,2,0,48,0.000199,0.002837,0.000704
"搞",搞,,2,7,0.264846,0.280705,439.697521,2,3,5,2,3,5,0,48,0.000383,0.003446,0.010894
"裁",裁,,0,8,0.23558,0.246719,34.075847,2,1,3,1,1,2,0,48,0.000287,0.002305,0.000937
"拨",拨,,3,7,0.252434,0.265663,299.848363,3,3,6,1,2,3,0,48,0.000397,0.000044,0.01053
"遏",遏,,0,8,0.240095,0.251361,12.734624,1,2,3,1,1,2,0,48,0.000237,0.001928,0.000573
"险",险,,0,8,0.205871,0.213518,537.021844,2,2,4,1,1,2,0,48,0.000264,0.019008,0.000095
"恶",恶,,0,7,0.259061,0.274348,1152.645711,3,3,6,2,3,5,0,48,0.000408,0.001862,0.005976
"劣",劣,,0,2,0.666667,0.75,1099.041667,3,3,6,3,1,4,0,1,0.00088,0.019129,0
"迹",迹,,0,2,0.666667,0.75,3.041667,3,1,4,1,1,2,0,1,0.00089,0,0.000975
"斑",斑,,0,2,0.666667,0.75,1,4,3,7,3,2,5,0,1,0.00102,0.019057,0.000978
"虐",虐,,4,11,0.13738,0.140477,0,0,1,1,0,1,1,0,72,0.000141,0,0
"囚",囚,,4,10,0.159117,0.163278,1117,1,1,2,1,1,2,0,71,0.000261,0,0
"丑",丑,,4,9,0.189056,0.195424,2232,1,1,2,1,1,2,0,70,0.000363,0,0.00014
"层",层,,4,7,0.249051,0.26196,299.917193,1,1,2,1,1,2,0,48,0.000421,0.000454,0.003157
"枪",枪,,3,8,0.203353,0.21041,0,0,1,1,0,1,1,0,73,0.000141,0,0.002521
"死",死,,5,8,0.192407,0.199257,1839.4608,2,2,4,2,2,4,0,48,0.000394,0.014845,0.000045
"裔",裔,,5,7,0.295443,0.315398,0,1,1,2,1,1,2,0,48,0.000211,0.00158,0.017311
"忧",忧,,1,0,0,0,0,1,0,1,1,0,1,0,4,0.000359,0.001068,0
"精",精,,0,8,0.242128,0.253789,58.666325,1,1,2,1,1,2,0,48,0.000215,0.000541,0.002346
"伐",伐,,0,7,0.251353,0.265644,46.861241,1,1,2,1,1,2,0,48,0.000264,0.000995,0.006302
"倒",倒,,2,7,0.23104,0.242238,1835.826437,5,5,10,4,3,7,0,48,0.000746,0.012034,0.002789
"耙",耙,,2,8,0.182877,0.18926,2188,3,2,5,1,2,3,0,48,0.000303,0.004097,0
"胡",胡,,2,7,0.220138,0.229458,981.70399,1,1,2,1,1,2,0,48,0.00027,0,0.002284
"八",八,,2,8,0.23927,0.251406,1140.195627,2,2,4,2,2,4,0,48,0.000418,0.005705,0.000567
"偏",偏,,0,7,0.227088,0.23713,56.083145,3,3,6,1,1,2,0,48,0.000282,0.000542,0.000302
"蓄",蓄,,0,8,0.246191,0.258513,20.488044,1,2,3,1,1,2,0,48,0.000234,0.004833,0.002887
"污",污,,2,8,0.198681,0.206384,2364.877187,3,3,6,3,2,5,0,48,0.000712,0.003176,0.000013
"蔑",蔑,,2,9,0.193576,0.20084,1178.357419,2,2,4,1,2,3,0,48,0.000444,0.000001,0.000622
"仍",仍,,2,8,0.242972,0.255425,5.521182,1,1,2,1,1,2,0,48,0.00022,0.00518,0.006756
"逆",逆,,8,8,0.237032,0.247738,20.853256,1,1,2,1,1,2,0,48,0.00019,0.002449,0.000111
"九",九,,5,8,0.242602,0.254633,36.906166,1,1,2,1,1,2,0,48,0.00023,0.001913,0.002514
"月",月,,2,0,0,0,0,1,0,1,1,0,1,0,20,0.00028,0.002412,0
"厚",厚,,0,9,0.194862,0.201141,15.696657,1,1,2,1,1,2,0,48,0.000274,0.000105,0.000264
"惠",惠,,7,7,0.256735,0.270551,170.476573,2,2,4,2,2,4,0,48,0.000447,0.002755,0.003074
"脱",脱,,7,7,0.274158,0.292432,1209.591565,10,10,20,7,4,11,0,48,0.001022,0.042135,0.01363
"除",除,,7,7,0.258341,0.27442,626.996746,5,5,10,3,3,6,0,48,0.000757,0.002355,0.00774
"亿",亿,,2,7,0.263905,0.277314,158.537648,1,1,2,1,1,2,0,48,0.000319,0.000029,0.007737
"胜",胜,,7,7,0.242972,0.256013,187.151963,2,2,4,2,2,4,0,48,0.000434,0.002953,0.003111
"围",围,,0,7,0.245865,0.257707,30.259282,2,2,4,1,1,2,0,48,0.000245,0.000617,0.00295
"践",践,,2,0,0,0,0,2,0,2,1,0,1,0,37,0.000315,0.002249,0
"框",框,,2,9,0.191515,0.197379,1094.5,1,1,2,1,1,2,0,48,0.000185,0.001793,0
"扎",扎,,2,8,0.243025,0.25547,126.417516,1,1,2,1,1,2,0,48,0.000317,0.000697,0.006756
0,0,,2,7,0.258401,0.271768,190.095797,1,1,2,1,1,2,0,48,0.000344,0.000129,0.004452
"缺",缺,,1,10,0.165283,0.169835,8.170671,1,1,2,1,1,2,0,48,0.000266,0.000094,0.000217
"扶",扶,,7,7,0.253409,0.266171,735.855492,3,3,6,3,2,5,0,48,0.000815,0.017188,0.001913
"云",云,,0,9,0.181448,0.186881,23.009839,1,1,2,1,1,2,0,48,0.000257,0.002065,0.000035
"麻",麻,,5,10,0.157109,0.160791,2187,1,1,2,1,1,2,0,48,0.000269,0.001421,0
"栗",栗,,5,9,0.186206,0.19164,2207,1,1,2,1,1,2,0,48,0.00037,0,0
"坡",坡,,5,8,0.22853,0.238024,2227,1,1,2,1,1,2,0,48,0.000456,0,0.002048
"县",县,,7,8,0.232679,0.242756,22.688715,2,1,3,2,1,3,0,48,0.000345,0.003509,0.003404
"摘",摘,,0,1,1,1,1096,1,1,2,1,1,2,0,15,0.000271,0.001097,0
"帽",帽,,0,0,0,0,0,1,0,1,1,0,1,0,14,0.000372,0,0
"巩",巩,,2,8,0.2009,0.207986,0,0,1,1,0,1,1,0,74,0.000141,0,0.000015
"固",固,,2,7,0.251183,0.264879,1205.339695,2,2,4,2,2,4,0,48,0.00037,0.000288,0.002541
"伊",伊,,4,7,0.265287,0.280662,1525.786335,9,9,18,5,4,9,0,48,0.000565,0.025767,0.004639
"朗",朗,,4,7,0.249162,0.262951,30.333285,2,2,4,1,2,3,0,48,0.000261,0.000237,0.006959
"旅",旅,,7,7,0.255734,0.269445,242.371558,1,1,2,1,1,2,0,48,0.000276,0.010026,0.001237
"志",志,,0,9,0.203765,0.211581,42.546719,1,1,2,1,1,2,0,48,0.000361,0.000438,0.000457
"阶",阶,,0,8,0.196927,0.203398,0,1,1,2,1,1,2,0,48,0.000303,0.004097,0.00021
"毕",毕,,7,0,0,0,0,1,0,1,1,0,1,0,3,0.000446,0.00041,0
"刻",刻,,2,8,0.246191,0.258513,92.942167,2,1,3,2,1,3,0,48,0.000372,0.002133,0.002887
"效",效,,2,8,0.243663,0.25588,794.330823,3,2,5,3,2,5,0,48,0.000504,0.009107,0.001645
"散",散,,2,7,0.216085,0.225076,24.899954,1,1,2,1,1,2,0,48,0.000262,0.000216,0.000819
"按",按,,8,8,0.20553,0.212807,95.764052,1,1,2,1,1,2,0,48,0.000217,0.002366,0
"宜",宜,,6,0,0,0,0,1,0,1,1,0,1,0,47,0.000297,0.002189,0
"岛",岛,,4,7,0.291579,0.310442,1013.610943,3,3,6,2,2,4,0,48,0.000593,0.00057,0.009485
"射",射,,0,8,0.241813,0.253296,46.978509,1,1,2,1,1,2,0,48,0.000231,0.000828,0.001618
"洋",洋,,4,8,0.232825,0.243488,207.262421,2,2,4,2,2,4,0,48,0.00045,0.00192,0.00117
"站",站,,2,7,0.260332,0.274982,2836.906152,3,3,6,2,3,5,0,48,0.000928,0.00049,0.005967
"含",含,,2,10,0.149144,0.152692,1112.499351,1,1,2,1,1,2,0,48,0.000404,0.000305,0
"氚",氚,,2,9,0.175094,0.180234,1132.499351,1,1,2,1,1,2,0,48,0.000485,0,0.000019
"废",废,,2,8,0.211977,0.220855,2988.885786,2,2,4,2,2,4,0,48,0.000691,0.000362,0.000272
"案",案,,5,7,0.238401,0.249618,303.259581,4,2,6,4,2,6,0,48,0.000697,0.016365,0.004051
"披",披,,2,8,0.207211,0.215247,50.081985,1,1,2,1,1,2,0,48,0.000271,0.001097,0.000051
"兜",兜,,2,9,0.184389,0.190073,56.877066,1,1,2,1,1,2,0,48,0.000519,0.000524,0.000198
"火",火,,6,0,0,0,0,1,0,1,1,0,1,0,0,0.000331,0.00044,0
"服",服,,6,8,0.237588,0.249032,27.899736,1,1,2,1,1,2,0,48,0.000391,0.000506,0.002351
"缘",缘,,5,7,0.232922,0.243051,15.720516,2,2,4,1,1,2,0,48,0.000332,0.001295,0.004786
"骨",骨,,2,9,0.19201,0.199382,24.607019,1,1,2,1,1,2,0,48,0.000338,0.000258,0.002605
"撤",撤,,5,8,0.202764,0.210189,83.041865,1,1,2,1,1,2,0,48,0.000248,0.002399,0.00007
"刚",刚,,3,8,0.221318,0.229624,16.803868,1,1,2,1,1,2,0,48,0.000188,0.003528,0.000527
"契",契,,5,8,0.215876,0.2239,26.66799,1,1,2,1,1,2,0,48,0.000226,0.007391,0.002414
"凝",凝,,7,9,0.168963,0.173713,0,0,1,1,0,1,1,0,75,0.000141,0,0.000051
"睦",睦,,1,8,0.230992,0.240991,51.501679,1,1,2,1,1,2,0,48,0.000276,0.010026,0.002962
"吹",吹,,2,9,0.191614,0.197891,17.586499,1,1,2,1,1,2,0,48,0.000235,0,0.000332
"洁",洁,,2,8,0.198117,0.205328,51.994219,5,5,10,1,1,2,0,48,0.000374,0.000008,0.001755
"竞",竞,,0,8,0.207365,0.21516,12.21166,1,1,2,1,1,2,0,48,0.000228,0.001099,0.000073
"凿",凿,,6,7,0.231857,0.242319,4.931768,1,1,2,1,1,2,0,48,0.000204,0.002149,0.002692
"警",警,,7,9,0.191292,0.197655,0,0,1,1,0,1,1,0,76,0.000141,0,0.000005
"音",音,,7,9,0.20425,0.212481,42.192374,1,1,2,1,1,2,0,48,0.000365,0.000116,0.00033
"肮",肮,,2,9,0.16543,0.169974,1101.82044,6,6,12,4,1,5,0,48,0.000549,0.048331,0
"脏",脏,,2,8,0.198081,0.205298,1121.82044,6,6,12,1,1,2,0,48,0.000608,0,0.001755
"呢",呢,,2,0,0,0,0,1,0,1,1,0,1,0,41,0.000216,0.001058,0
"五",五,,0,8,0.23042,0.239727,47.005133,1,1,2,1,1,2,0,48,0.00022,0.004947,0.000099
"序",序,,8,7,0.2509,0.263421,3.131973,1,1,2,1,1,2,0,48,0.00024,0.001994,0.010349
"垄",垄,,0,8,0.214423,0.223741,112.961385,2,2,4,2,1,3,0,48,0.000339,0.012078,0.00026
"霸",霸,,0,7,0.248662,0.260162,1839.865403,2,2,4,2,2,4,0,48,0.00057,0.000747,0.002132
"某",某,,2,7,0.259302,0.273523,20.80165,1,1,2,1,1,2,0,48,0.000228,0.001086,0.009609
"盗",盗,,0,8,0.238248,0.248987,33.030395,1,1,2,1,1,2,0,48,0.000293,0.000762,0.00404
"屡",屡,,0,7,0.227041,0.237085,61.503952,1,1,2,1,1,2,0,48,0.000312,0.002576,0.000302
"芝",芝,,8,7,0.244518,0.257147,39.82071,1,1,2,1,1,2,0,48,0.000342,0.000688,0.00253
"凌",凌,,0,7,0.295521,0.315443,372.743406,1,1,2,1,1,2,0,48,0.000384,0.000109,0.017311
"词",词,,2,0,0,0,0,1,0,1,1,0,1,0,12,0.00029,0.000912,0
"画",画,,5,8,0.24025,0.251195,38.913571,1,1,2,1,1,2,0,48,0.000212,0.010555,0.002682
"牢",牢,,5,8,0.22783,0.237156,47.677056,1,1,2,1,1,2,0,48,0.000226,0.007391,0.000303
"趣",趣,,5,0,0,0,0,1,0,1,1,0,1,0,5,0.000492,0.000129,0
"询",询,,5,7,0.242602,0.253968,20.931574,1,1,2,1,1,2,0,48,0.000228,0.001254,0.00233
"阐",阐,,4,8,0.237083,0.248007,5.27619,1,1,2,1,1,2,0,48,0.000264,0.002498,0.001961
"刊",刊,,6,8,0.232728,0.243945,55.693119,1,1,2,1,1,2,0,48,0.000321,0.000298,0.008853
"录",录,,2,7,0.268869,0.285712,78.009353,1,1,2,1,1,2,0,48,0.000315,0.002249,0.009244
"频",频,,0,0,0,0,0,1,0,1,1,0,1,0,19,0.000301,0.002552,0
"香",香,,4,8,0.228063,0.237618,115.501356,1,3,4,1,1,2,0,48,0.000252,0.003801,0.00006
"乱",乱,,2,9,0.173811,0.17878,6.612068,1,1,2,1,1,2,0,48,0.00034,0.000577,0.001126
"庇",庇,,3,8,0.242128,0.253334,23.402486,1,1,2,1,1,2,0,48,0.000215,0.001326,0.000067
"楚",楚,,2,0,0,0,0,1,0,1,1,0,1,0,26,0.000374,0.000008,0
"拘",拘,,6,8,0.201082,0.207878,386.99766,1,1,2,1,1,2,0,48,0.000279,0.002747,0.000004
"押",押,,6,7,0.251409,0.264512,1231.962806,2,2,4,2,2,4,0,48,0.000541,0.00007,0.010455
"孟",孟,,6,8,0.195203,0.201108,405.350257,3,3,6,3,1,4,0,48,0.00058,0.002067,0.000042
"晚",晚,,6,7,0.242339,0.253265,2231.813945,4,4,8,2,2,4,0,48,0.000727,0.000828,0.001272
"舟",舟,,6,7,0.298288,0.319359,1262.420447,3,3,6,1,3,4,0,48,0.00045,0.000065,0.020529
"敢",敢,,0,8,0.246354,0.258502,35.79747,1,1,2,1,1,2,0,48,0.000243,0.003521,0.005099
"逮",逮,,5,8,0.227458,0.236606,177.991529,3,3,6,2,1,3,0,48,0.00054,0.002751,0.000001
"绝",绝,,0,7,0.251295,0.265585,0,0,1,1,0,1,1,0,77,0.000141,0,0.006302
"逞",逞,,0,7,0.295521,0.315443,75.724509,2,1,3,1,1,2,0,48,0.000249,0.001669,0.017311
"释",释,,0,8,0.223851,0.23336,581.23048,1,1,2,1,1,2,0,48,0.000254,0.000019,0.001444
"考",考,,8,9,0.193846,0.199863,29.293561,1,1,2,1,1,2,0,48,0.000256,0.00276,0
"虑",虑,,8,8,0.24025,0.251195,1328.55324,2,1,3,2,1,3,0,48,0.000975,0.000002,0.002682
"早",早,,7,9,0.18445,0.189768,3.331818,1,1,2,1,1,2,0,48,0.000196,0.0009,0.000326
"办",办,,5,7,0.260758,0.275998,1239.74009,3,3,6,3,3,6,0,48,0.000638,0.004397,0.013878
"嫌",嫌,,2,8,0.211254,0.219135,1141.912389,2,2,4,2,2,4,0,48,0.000466,0.001297,0.00031
"侦",侦,,5,8,0.20698,0.214551,110.274077,1,1,2,1,1,2,0,48,0.00024,0.00964,0.000225
"疑",疑,,2,7,0.263968,0.277359,974.887433,1,1,2,1,1,2,0,48,0.000339,0.000016,0.007737
"遭",遭,,0,8,0.211254,0.218903,16.921993,1,1,2,1,1,2,0,48,0.000253,0.001355,0.001116
"颠",颠,,2,8,0.187805,0.193865,131.29601,1,1,2,1,1,2,0,48,0.00027,0,0.000616
"白",白,,2,0,0,0,0,1,0,1,1,0,1,0,2,0.000358,0.000568,0
"控",控,,7,9,0.176118,0.18138,11.447554,1,1,2,1,1,2,0,48,0.000301,0.000049,0.000323
"辄",辄,,0,8,0.22825,0.239032,24.610964,1,1,2,1,1,2,0,48,0.00022,0.004947,0.003054
"谍",谍,,0,8,0.234047,0.24427,2.567995,1,1,2,1,1,2,0,48,0.000234,0.00146,0.001705
"荒",荒,,6,9,0.173866,0.178831,1098.017319,1,1,2,1,1,2,0,48,0.000265,0.00368,0
"谬",谬,,6,8,0.210258,0.218528,1118.017319,1,1,2,1,1,2,0,48,0.000367,0,0.000423
"损",损,,5,8,0.22783,0.237156,106.966598,6,5,11,4,1,5,0,48,0.000728,0.021045,0.000303
"演",演,,0,8,0.245433,0.257056,74.302458,1,1,2,1,1,2,0,48,0.000276,0.002504,0.000513
"赤",赤,,0,8,0.228296,0.237455,1094,1,1,2,1,1,2,0,48,0.000226,0.007391,0
"裸",裸,,0,7,0.295521,0.315443,1114,2,2,4,2,2,4,0,48,0.000334,0,0.017311
"毁",毁,,2,7,0.252892,0.266282,1283.297954,2,2,4,2,2,4,0,48,0.000606,0.00113,0.011135
"卡",卡,,8,9,0.181389,0.186725,1145.665922,2,2,4,1,1,2,0,48,0.000413,0.000004,0
"锡",锡,,8,8,0.221362,0.230541,1165.665922,2,2,4,1,1,2,0,48,0.000492,0,0.001876
"臭",臭,,2,7,0.218114,0.226835,71.032945,1,1,2,1,1,2,0,48,0.000255,0.003081,0.000588
"昭",昭,,2,8,0.228296,0.237455,1094,1,1,2,1,1,2,0,48,0.00029,0.000912,0
"著",著,,2,7,0.295521,0.315443,1114,1,1,2,1,1,2,0,48,0.000388,0,0.017311
"灰",灰,,5,8,0.20939,0.217324,211.749101,1,1,2,1,1,2,0,48,0.000309,0.000002,0.001233
"燃",燃,,8,8,0.20306,0.210734,21.39369,1,1,2,1,1,2,0,48,0.000292,0.00051,0.000548
"尸",尸,,8,7,0.237487,0.249396,99.447412,1,1,2,1,1,2,0,48,0.000406,0.000205,0.002435
"魂",魂,,5,0,0,0,0,1,0,1,1,0,1,0,23,0.000248,0.002399,0
"斐",斐,,5,7,0.288785,0.30773,958.004178,12,14,26,6,3,9,0,48,0.000837,0.022817,0.005301
"勒",勒,,1,8,0.214176,0.221643,22.06648,1,1,2,1,1,2,0,48,0.000295,0.000881,0.00009
"伪",伪,,0,8,0.208801,0.217588,4711.561025,3,3,6,3,2,5,0,48,0.000788,0.005408,0.000022
"悬",悬,,0,10,0.147565,0.151141,1096.166949,1,1,2,1,1,2,0,48,0.000235,0.000533,0
"挂",挂,,0,9,0.172922,0.178069,1116.166949,1,1,2,1,1,2,0,48,0.000341,0,0.000277
"蛋",蛋,,0,8,0.200504,0.20716,1117.705554,1,1,2,1,1,2,0,48,0.00032,0.000051,0
"糕",糕,,0,7,0.250506,0.263116,1137.705554,1,1,2,1,1,2,0,48,0.000413,0,0.002547
"太",太,,0,8,0.220705,0.230225,30.658285,1,1,2,1,1,2,0,48,0.00019,0.006795,0.001172
"谋",谋,,5,7,0.237841,0.249231,61.68069,1,1,2,1,1,2,0,48,0.000366,0.000726,0.001739
"引",引,,8,7,0.2509,0.263421,297.433693,1,1,2,1,1,2,0,48,0.000394,0.000135,0.010349
"庆",庆,,5,8,0.215417,0.223354,66.789078,1,1,2,1,1,2,0,48,0.000217,0.016357,0.000545
"酒",酒,,0,9,0.185001,0.191071,1094,1,1,2,1,1,2,0,48,0.000303,0.004097,0
"店",店,,0,8,0.226764,0.237578,1114,1,1,2,1,1,2,0,48,0.000399,0,0.00591
"衅",衅,,3,7,0.268934,0.285787,446.832441,1,1,2,1,1,2,0,48,0.000397,0.000044,0.009244
"肢",肢,,2,7,0.216043,0.225031,428.618849,1,1,2,1,1,2,0,48,0.000276,0.010026,0.000819
"冲",冲,,2,8,0.2,0.207165,17.118652,1,1,2,1,1,2,0,48,0.000279,0.000361,0.000975
"伤",伤,,6,8,0.226075,0.235983,63.568876,1,1,2,1,1,2,0,48,0.000352,0.000376,0.000441
"究",究,,5,8,0.223806,0.232922,58.59932,1,1,2,1,1,2,0,48,0.000359,0.00001,0.001269
"贺",贺,,6,0,0,0,0,1,0,1,1,0,1,0,10,0.000292,0.000205,0
"届",届,,3,7,0.232874,0.243007,27.938942,1,1,2,1,1,2,0,48,0.000303,0.004097,0.004786
"礼",礼,,0,7,0.243982,0.256633,43.033158,1,1,2,1,1,2,0,48,0.000319,0.000583,0.002848
"遗",遗,,8,9,0.195101,0.201418,1094,1,1,2,1,1,2,0,48,0.000243,0.003521,0
"余",余,,8,8,0.242181,0.253834,1114,1,1,2,1,1,2,0,48,0.000348,0,0.002346
"诋",诋,,2,8,0.202066,0.208952,98.07715,1,1,2,1,1,2,0,48,0.00033,0.000032,0.000058
"濒",濒,,0,9,0.163971,0.168093,2187,1,1,2,1,1,2,0,48,0.000344,0.001798,0
"危",危,,0,8,0.195923,0.202283,2207,1,1,2,1,1,2,0,48,0.000434,0,0
"野",野,,0,7,0.243344,0.255148,2227,1,1,2,1,1,2,0,48,0.00051,0,0.004028
"森",森,,6,10,0.164649,0.16896,1106.288889,1,1,2,1,1,2,0,48,0.000263,0.001385,0
"林",林,,6,9,0.196927,0.203728,1126.288889,1,1,2,1,1,2,0,48,0.000365,0,0.000271
"诸",诸,,6,7,0.258341,0.271723,42.836859,1,1,2,1,1,2,0,48,0.000265,0.00368,0.004452
"戳",戳,,4,8,0.202946,0.209576,0,0,1,1,0,1,1,0,78,0.000141,0,0.000389
"雄",雄,,8,9,0.185001,0.191071,1094.262338,1,1,2,1,1,2,0,48,0.000231,0.002048,0
"辩",辩,,8,8,0.226764,0.237578,1114.262338,1,1,2,1,1,2,0,48,0.000338,0,0.00591
